item	src
ｙｏ，這位Ｂｒｏｔｈｅｒ	bracket
＿啦幹	bold
ＹＹ跟街亭誰難守	bracket
ＸＸ守得住街亭嗎？	bracket
ＯＯ事件	bold
＝有情有義＝	bracket
＜3	title
３６＋４５＝７９似乎不是唯一解	link_title
（香港）已經是共產黨的形狀了	bracket
（拔草）測風向	title
龜頭	bracket
龜透	bracket
龜豆貝	bracket
龜投	bracket
龜托	bracket
龜多	bracket
龜仔	bracket
龍騎士	bold
龍陽	link_title
龍王	bold
龍族拼圖板	link_title
龍巖	bracket
龍五的手上只要有槍，誰都沒有辦法殺他的	bracket
齊頭 XD 遊戲	bracket
鼻子	bracket
鼎泰豐	link_title
黨內互打免費，不降速	bracket
黨內互打免費	bracket
點站歌、寫感想	bracket
點滑鼠大賽	link_title
點名文	link_title
點兔騎士來喔	bracket
點兔文	link_title
點兔團	link_title
黑色的字	link_title
黑皮板（happy）	title
黑皮板	link_title
黑的最莫名的名人是誰？	bracket
黑特點	link_title
黑特王朝	bracket
黑特版緊急尋人救命事件	link_title
黑特版	link_title
黑特板緊急尋人救命事件	link_title
黑特板板主罷免事件	link_title
黑特板主亂板事件	link_title
黑特板、恨板	bold
黑特板	link_title
黑特文	link_title
黑特416事件	link_title
黑特	link_title
黑熊王	bracket
黑死爪	bracket
黑掉	bracket
黑幫王	bold
黑人	link_title
黃金交叉	bracket
黃色鬼屋	link_title
黃琪事件	link_title
黃爆	bold
黃忠中路無敵，歡迎單挑	bracket
黃俊英賄選抓到了	bracket
黃「爆!」	link_title
麻里愛	bracket
麻繩理工學院	bracket
麻繩不夠用	bracket
麥當勞歡樂送	link_title
鹿男	link_title
鹼民	bold
鷹爪門的站出來	bracket
鵝鵝鵝	link_title
鴿子封包	bracket
鳳梨酥不是鳳梨做的	bracket
鳳山凱名事件	link_title
鳥不起	bracket
鯰姐	title
鯰亂	bracket
鮑紅	bracket
魯蛇宅宅	bracket
魯蛇、溫拿	title
魯蛇	link_title
魯宅	bracket
魯夫的蛇	bracket
魯叔魯叔 起床賺三百	bracket
魯叔	bold
魚魚之亂	link_title
魚王	bracket
魔獸版	link_title
魔獸板	link_title
鬼頭	bracket
鬼神童子	bracket
鬼島法律	bracket
鬼島歌詞王	bracket
鬼島政府	bracket
鬼島媒體	bracket
鬼島俳句	bracket
鬼島不意外	bracket
鬼島	link_title
鬧板	link_title
鬍鬚張	link_title
鬍子哥事件	link_title
鬍子哥	link_title
鬍子事件	link_title
鬍子	link_title
髮夾彎	bracket
高雄郭采潔	bracket
高雄郭書遙	bracket
高雄王	bracket
高雄港務局	bracket
高雄板	link_title
高雄	link_title
高速詠唱	link_title
高速神言	bold
高調	link_title
高義你他媽雜碎	link_title
高義	link_title
高火線	bracket
高火	link_title
高溫事件	link_title
高棉王	bracket
高捷男事件	link_title
高富帥	bracket
高富奸	bracket
高嘉瑜	link_title
高中板之亂	link_title
高中板	link_title
高中之亂	link_title
體適能版	link_title
髒話王	bold
骨科戰神	bracket
骨科大	link_title
驚彈炸裂	bracket
騜民	bracket
騎小隻馬	bracket
騎士團	link_title
馮魏石之亂	link_title
馬雲失街亭	bracket
馬雅重生ONLINE	bracket
馬雅國駐臺辦事處	bracket
馬雅國史館	bracket
馬雅人	link_title
馬路三寶	link_title
馬超失街亭	bracket
馬賽傳奇	bracket
馬英九終於做對一件事	bracket
馬芙丸.avi	bracket
馬習會	bracket
馬總統硬起來了	bracket
馬維拉	bracket
馬子	bracket
馬奶圖	link_title
馬奶	link_title
馬囧失街亭	bracket
香蕉	bracket
香腸攤雞排	link_title
香港迪士尼遇到邱淑貞	link_title
香港迪士尼樂園遇見邱淑貞	link_title
香帥	bold
首頁	title
餵公子吃餅	link_title
館長能不能打贏 XXX	bracket
館長打得贏泰森嗎	bracket
館長之亂	link_title
館長	link_title
餓死抬頭	title
餓了	bracket
養樂多隊板	link_title
養帳號	bold
養好一個ID	link_title
養分身	bracket
養公主	bracket
養ID（養帳號）	title
養ID	bold
飽板	link_title
食蕉！！家下可以俾D人打完又打、打完又打、打完又打、打完又打嘅咩	bracket
食神	link_title
食物	link_title
飛鴿傳書	bold
飛馬圖案	link_title
飛馬	bracket
飄板	link_title
風向	bracket
顯示卡	link_title
顯卡板	link_title
類組	link_title
願意接受祝福嗎(y/n）	link_title
願意接受祝福嗎(y/n)？	bold
顏色錯誤	bold
顏色正確	link_title
顏色對了	bracket
顏色不對、顏色對了	title
顏色不對	bracket
顏文字	link_title
頸推	link_title
頭香	bracket
頭殼之亂	link_title
頭殼	bracket
頭推、頸推、胸推	link_title
頭推	link_title
領麻繩、給XX一條麻繩	title
領麻繩	bracket
領五百元	link_title
頗ㄏ	link_title
預設格式化內容	bracket
預言文	link_title
頂新事件	link_title
音樂聽光光	bracket
韓星板 (Korea Star)	title
韓星板	bold
韓國語板	link_title
韓國旅遊板	link_title
韓劇板	link_title
鞋板	link_title
面試達人	bracket
靠邀，圖勒	bracket
靠邀！圖咧	link_title
靠邀為什麼用手機推文自己多出一個字...	bracket
靠邀	bracket
靠父母進演藝圈	bracket
靠夭！圖咧！	bold
靠北部落客	bracket
靠北女友	link_title
靠么，圖咧	link_title
靠么	bracket
非零和盤專用區	bracket
非關	bracket
非洲人	bracket
非常魯	bracket
非常的ㄏㄏ	bracket
靜（冷靜、板面設靜）	title
靜板	link_title
青蘋果樹	link_title
青藍爆	link_title
青藍「爆!」	link_title
青春肉體	bracket
靈的轉移	bracket
靈的網羅	link_title
霸氣外漏	bracket
霸氣	bracket
霸凌	bracket
電視	bracket
電蝦版	link_title
電蝦板	link_title
電蝦	link_title
電腦練蠱（hao123、金山毒霸、360安全衛士…）	title
電腦練蠱	bold
電腦白痴	link_title
電腦	link_title
電梯向下	bracket
電影版	link_title
電影板	link_title
電影台詞推文	bold
電影	link_title
雷文	link_title
雷姆	link_title
雷公	bracket
雷、捏他	title
零食	bracket
零勝恩	bracket
零分	bracket
雲朵	bracket
雲南山歌	bracket
雪公	bracket
雪兒版	link_title
雨狗表示	bracket
雨狗大	bold
雨狗	bold
雨八令刀	link_title
雨八	link_title
難道阿扁不用負責嗎	bracket
難道你要投國民黨？	bracket
難道XX版也富奸化了？	bracket
難過	bracket
難忘的回憶	bracket
難受想哭	bracket
雞雞軟軟的	bracket
雞雞硬硬	bracket
雞雞	bracket
雞肉	bracket
雞桶	bold
雞排配珍奶	bracket
雞排要切不要辣	bracket
雞排事件	link_title
雞排、珍奶、板凳	bold
雞排	link_title
雜魚	bracket
雜七雜八短篇漫畫翻譯	bracket
雙魚板	link_title
雙腿一軟	bracket
雙P之亂	link_title
雖敗猶榮	bracket
集氣文	link_title
集氣	link_title
雅量背影出師表	link_title
雅量	link_title
雅美蝶	link_title
隱身	link_title
隱藏板規	bracket
隱版	link_title
隱板	link_title
隱性同志	bold
隨虎哥的精神	bracket
隔空水桶	link_title
隔壁板	bracket
陽痿	bracket
陽光沙灘	link_title
陳菊.rmvb	bold
陳菊.avi、陳菊.rmvb	title
陳菊.avi	bold
陳興	bracket
陳柏惟	link_title
陳星婗	bold
陳星女兒	bold
陳星	link_title
陳平偉	bracket
陳嘎尾	bracket
陰謀論	bracket
除非你爸變成了兔子	link_title
除暴安良是我們作市民的責任，行善積德是我本人的興趣，所以扶老太太過馬路我每個星期都做一次，如果是碰到國定假日的話，我還做兩、三次呢	bracket
陣線文	link_title
陣線之亂	link_title
阿～斯	bold
阿～嘶、阿斯	title
阿麗	bracket
阿陸（仔）	bracket
阿門	bracket
阿銀，本來我就看錯你了，這下我更加看錯你了，輕易地就刷新了你的下限	bracket
阿里空空	bold
阿苗	bold
阿肥套餐	bracket
阿肥。台灣師大國文系畢業，	bold
阿磨	link_title
阿斯	link_title
阿扁	bracket
阿建	bold
阿康	bold
阿宅	bracket
阿嬤之亂	link_title
阿婆牛肉麵	bracket
阿公眼鏡髒，太太看成娘，指著紗窗說藍色蜘蛛網	bold
阿信	link_title
阿不就很厲害	bracket
阿不就好棒棒	link_title
防雷	bracket
防閃	bracket
防捏	bracket
關鍵字問卦、關鍵字之亂	title
關鍵字問卦	link_title
關鍵字之亂	link_title
關鍵字	bracket
關說	bracket
關燈	link_title
關板	bracket
關於金針菇的文章	bracket
關心則亂	bracket
關係人	bracket
閹割	bracket
閱懶室	bracket
閩南人	link_title
閒聊文	link_title
閒聊	bracket
開車	bracket
開薰	bracket
開花水桶	bracket
開花大叔	bold
開燈、關燈	bold
開燈	link_title
開始狂風暴雨	bracket
開始	bracket
開啟聖人模式	bracket
開司	bracket
開勳	bracket
閃光彈	bracket
閃光便利貼	bracket
閃光、墨鏡、可魯、空白文	link_title
閃光	link_title
長毛？是你？	bracket
鐵道板（Railway）	link_title
鐵道時刻板（RailTimes）	link_title
鐵路佐級養路工程	bracket
鐵皮屋挖洞中	bracket
鐵皮哥	bracket
鐵皮	bracket
鐵拳無敵孫中山	link_title
鐵手套	bold
鏡花水月	bracket
鎧之	bracket
鎖文	bold
鎖定文章	bold
鍵盤金城武	bracket
鍵盤鄉民	link_title
鍵盤美軍	bracket
鍵盤的 1 是不是壞掉了	link_title
鍵盤正妹	bracket
鍵盤柯南	link_title
鍵盤小妹	link_title
鍵盤XX	bracket
鍵盤	bracket
錯怪馬英九了	bracket
錢包裡沒有錢	bracket
鋒炮炸裂	bracket
銅鋰鋅	link_title
銅李星	bracket
銃子	bold
銀魂板	link_title
鈴木一朗	link_title
鈕承澤	link_title
釣魚高手	bracket
釣魚文	link_title
釣魚	link_title
釣馬雅人	link_title
釣金魚文	bracket
釣得到 XX 我就 XX	bracket
釣客	bracket
釣卡好	bracket
釣到	link_title
釣中	bracket
金鶯重砲猛擊小龜頭昏腦脹	bracket
金魚	bold
金針菇王	bracket
金針菇	bracket
金排球	link_title
金庸板	link_title
金庸大	bold
金山毒霸	bold
金寶事件	link_title
金城武	link_title
野豬騎士來囉	link_title
野豬騎士來喔~	bracket
野豬騎士來喔	bold
野生朱學恒	bracket
重鬱男和牙醫女	bracket
重考板	link_title
重罰N萬	bracket
重慶市警方端掉一跨國網絡賭博窩點	bracket
重判三年	bracket
醫師法	bold
醫學系算文組還是理組	bracket
醫學生板	link_title
醒醒吧，你根本沒有女朋友	bold
醒醒吧，你根本沒有XXX	bold
醒醒吧！你（根本）沒有妹妹	link_title
醒醒吧你沒有右手	bracket
醒醒吧你根本沒有發文	bracket
醒醒吧你根本沒有上PTT	bracket
酸陽戰隊	bracket
酸陽岱鋼戰隊	bold
酸民不意外	bracket
酸民	link_title
酸人	bracket
酒駕、屁孩、老人	bracket
鄭公	bold
鄭先生的遊戲	bracket
鄭先生	bold
鄉霸	bracket
鄉長	link_title
鄉民都30cm起跳的	bold
鄉民證	bold
鄉民請雞排事件	link_title
鄉民爪爪日	bracket
鄉民有約	link_title
鄉民暴動	link_title
鄉民晚報	link_title
鄉民投票獲gogoro	bold
鄉民宴	link_title
鄉民卡	bold
鄉民們被打臉	bracket
鄉民不意外	bracket
鄉民	link_title
都是愛莉的錯	bracket
都是愛莉不好	bold
都是你害的	bracket
都是they的錯	bracket
都幾？!	bracket
都幾	title
郭雪芙和她的快樂夥伴	bracket
郭美江牧師在PTT	link_title
郭冠英事件	link_title
郎財女貌	bracket
邱若男，我要幹死妳	bracket
邱若男，我要幹死你！	bracket
邪神	link_title
那話兒不容易軟	bracket
那裡找來這麼多藍染新聞	bracket
那有老爸會在危急的時候拋下自己的孩子不顧去逃命的?	bracket
那是什麼	bracket
那就是排骨酥湯阿幹	link_title
那就是排骨酥湯啊幹	link_title
那就是XXX啊幹	bracket
那個簽名檔就是單純app拿來打廣告用的，林北就是不想讓他打廣告	bracket
邊緣人板	link_title
邊緣人	link_title
還真機靈	bracket
還是公車	bracket
還是XX	bracket
還是5566唱得更好	bracket
還好我都用pcman	link_title
還好我都用 xx	bracket
還好我都用 pcman	bracket
還不是靠新球、還不是靠XX	link_title
還不是靠新球	bracket
還不是靠兄弟	bracket
選舉就是這樣，別讓勝文不開心	bracket
選舉	bracket
選老婆	link_title
選擇性失明	bracket
選奶大的	bold
選前黨內免費互打刀刀見骨，選後全民爭討黨產拳拳到肉	bracket
遠東航空	bold
遠古文明板	link_title
遛鳥俠	bracket
遙不可及的期待	bracket
道歉時露出胸部是常識吧！	bracket
道歉時露出胸部是常識吧	bold
道歉時露出胸部不是常識嗎？	bracket
道歉時露出…	bracket
道歉時露出__是常識吧	bracket
道歉時…	bracket
道歉文	link_title
道歉	link_title
道德的自然史	bracket
過譽文、過氣文	link_title
過譽文	bold
過譽之亂	link_title
過譽	bracket
過水流大師兄	bold
過氣文	bold
過氣不再受到支持	bracket
過氣	bold
過於強大	bracket
遊戲設計板	link_title
遊戲結束	bracket
進板圖爭議事件	link_title
進板圖	link_title
進擊的美江 OP 紅蓮的鑽石	bracket
進擊的XX	bracket
進入聖人模式	bracket
週經文	bracket
連署	link_title
連營網軍事件	link_title
連可魯也閃瞎了	bracket
連XX也可以蓋地鐵喔	bracket
逢56必噓	bracket
造反啦	bracket
造反	bracket
通靈王大戰	link_title
通往天堂的鑰匙	bracket
這麼早吃三寶飯太油了吧	bracket
這麼多姓馬的來守街亭還是守不住	bracket
這裡面	bracket
這裡是八卦板	bracket
這裡是八仙樂園板	bracket
這裡是八仙樂園	link_title
這裡是八	bracket
這裡是X	bracket
這裡不是可愛板	bracket
這篇被推爆我就請吃雞排	bracket
這篇被推爆我就再發續集	bracket
這篇沒xx我就oo	bold
這篇沒XX我就oo	link_title
這篇沒XX我就OO	link_title
這篇會爆 我就切雞雞	bracket
這篇新聞讓你覺得…	bracket
這篇文章曾經存在，直到它的膝蓋中了一箭	bracket
這篇文章寫太長、太艱深或沒意思，我沒耐心看完	bracket
這篇應該置底當八卦入門手冊	bracket
這篇好臭	bracket
這種要求我還是第一次聽到	bracket
這種要求我這輩子沒見過	bracket
這種要求我一輩子都沒聽過	bracket
這種	bracket
這看板曾經可以進入直到它的膝蓋中了一箭	bracket
這樣才能削到你這隻老狐狸	bracket
這樣	bracket
這是要逼死誰	link_title
這是什麼巫術!	bracket
這是什麼巫術	bold
這文章加了洋蔥	bracket
這才是八卦板啊	bracket
這我知道	bracket
這我一定告。	bracket
這我一定告	bracket
這我一定吉	link_title
這就是當歸啊	bracket
這就是人蔘啊	bracket
這就是人生啊	bracket
這哪部？	bracket
這只是噱頭	bracket
這個舞台將成為各位回憶美好初戀的一個平台	bracket
這個帳號怎麼整天在發文	bracket
這個	bracket
這位大大	bracket
這不是一行文	bracket
這不叫XX什麼才叫XX	bold
逆逆	bracket
逆喝喝、逆呵呵	title
逆喝喝	bracket
逆呵呵	bracket
逆你老母	bracket
逆三小	bracket
逃離鬼島	bracket
送我一把武士刀吧	bracket
退選	bracket
退註	link_title
退文 (退回文章、劣文)	title
退文	link_title
退回文章	bold
退回帳號認證資格	bracket
退回	bracket
追星板	link_title
迷你妖五八	bold
迪士尼遇到邱淑貞	link_title
近西	bold
辦桌王	bold
辜莞允(Nono)照片事件在ptt、七之亂、小雪事件與小雪之亂	title
辜莞允	link_title
辛普森家庭中文版與ptt（含相關梗整理）	title
辛普森家庭中文版	bold
轟轟隊長	bracket
轟轟戰隊	bracket
轟轟大使	bracket
轟轟	bracket
轟動之亂	link_title
轉錄	link_title
轉信	link_title
轉cute板	bracket
輸了	bracket
輪班星人	link_title
輕鬆隨便發個文	bracket
輔大猴	link_title
軍旅版	link_title
軍旅板	link_title
車輪黨黨證	link_title
車板	link_title
車子有異音	bracket
車參聖整形外科	bracket
躺著也中槍	link_title
身寸☆惹ㄦ」(射惹ㄦ)	bold
蹦蹦跳姆咪	bracket
踹共文	link_title
踹共	link_title
踩到雷	bracket
踢爆	bracket
踏腳布	bracket
跳針	bracket
路過的貓	bold
路洨比相機事件	link_title
路洨比事件	link_title
跪著看電腦	bracket
跪著看銀幕	bracket
跪著滑手機	bracket
跪著推文	bracket
跪著打電腦	bracket
跪著打字	bracket
跪著上ptt	bracket
跪求	bracket
跪在電腦前	link_title
跪在銀幕前	bracket
跪下	link_title
跟鄉民（酸民）認真就輸了	bracket
跟鄉民認真就輸了	link_title
跟上	bracket
跟xx認真就輸了	bold
跑道	bold
趕快推，不然別人會以為我們看不懂	bold
越想越不對勁	title
越南王	bracket
越位	bold
超級喜歡	link_title
超爽的撿到一百塊	bracket
超爽的!撿到50機和40榴	bracket
超爽ㄉ	bracket
超爽der	bracket
超後悔投給柯P的	bold
超後悔投給柯P	link_title
超大型	bracket
超厲害der	bracket
超☆冒險蓋	link_title
趁亂告白	link_title
起鬨	bracket
起飛	link_title
起風了，丞相	bold
起手式	link_title
贓款	bracket
贈送板	link_title
賭神怎麼還不變超級賽亞人	bracket
賭神	link_title
賭盤	link_title
賭博	bracket
賭俠	link_title
賣場	link_title
賢者状態	bracket
賢者モード	bracket
賢者タイム	bracket
資源	link_title
資深刺迷版友拷貝貓(Copycat3)	bold
資料庫	bracket
資料中的其中一個數據。	bold
賄選王ㄈ仔	bracket
賄選王	link_title
費雯	bracket
買普洱茶	link_title
貴為板主	bracket
貢丸湯裡也沒有米田共	bracket
負雷	bracket
貝爾托特‧胡佛	bracket
豬油不意外	bracket
豬哥亮頭	bracket
豪繩	bracket
豪神	bracket
豪洨文	link_title
象魯閣	bracket
象迷不意外	bracket
象腿幫霸凌事件	link_title
豆頁	bracket
豆導文	link_title
豆導在PTT	link_title
豆導	bold
讚美馬英九徵文比賽	link_title
讚嘆	bracket
讚 留言 分享	title
讓她生！讓她生！（讓他爆、讓他昇）	title
讓她生、讓她生！	bold
讓她生、讓她生	bracket
讓她生	bracket
讓女板更好	bracket
讓他爆，讓他爆	bracket
讓他爆、讓他爆	bracket
讓他爆	bold
讓他昇、讓他昇	bracket
讓他昇	bold
讓人丟臉	bracket
讀姐	bold
讀大葉，掃落葉	bracket
讀大葉，媽哽咽	bracket
讀大葉，好就業，就好業，開巨業（註：當台中的公車業者巨業交通的駕駛），成霸業，創偉業，造宏業，向未來說YA	bracket
讀大葉，即失業	bracket
讀大葉，上大夜	bracket
護航、偷拍粉	bracket
護理師	bold
護士與護理師之爭	title
護士ptt裝路人推文護航，攻擊同業	bracket
護士	bold
護國ID	bracket
警察先生就是他	link_title
警告	link_title
警世圖	bold
證明所言不虛	link_title
謝震武	bracket
謝金魚	bold
謝謝大家	bracket
謝謝你，刀大	bracket
謝謝你9527	bracket
謝謝 現在急用	bracket
謝祖武	bracket
謙卑、謙卑再謙卑	bracket
諸神之黃昏	link_title
諧音或訛字	link_title
論點很特殊奇怪，可是又似乎有道理讓人想要相信	bracket
論壇	link_title
請退選	link_title
請蔡英文放過艦娘	bold
請蔡英文放過○○	link_title
請蔡英文放過....	bracket
請自備墨鏡	bracket
請看熱鬧的『鄉民』退到黃線外面去	bracket
請洽專板	link_title
請洽jay板	bracket
請洽XX版	bracket
請洽XX板	bracket
請求上車	bracket
請教XX獵人	bracket
請把胖次還給我	bold
請問這算吳鳳接鬼嗎?	bracket
請問您今天要來點兔子嗎？在PTT（不用不用= =、點兔騎士）	link_title
請問您今天要來點兔子嗎	link_title
請問中鋼可以買嗎？	bracket
請勿開槍，勿灌機油	bracket
請勿發表十八禁或類十八禁文章/圖/影片/連結	bracket
談台灣男性的自卑與排外情結	bracket
調情	bracket
誹謗	bracket
課金爆死非洲人	bracket
課堂分組	bold
誰會要你啊	bracket
誰是 JAY 的接班人？	bracket
誰在八卦版罵小馬試看看，ㄧ定劣退	bold
誰在八卦版罵小馬試看看,ㄧ定劣退	bracket
誰在八卦板罵小馬試看看，ㄧ定劣退	link_title
說我帥，太沉重	bracket
說好的正直與善良呢？	bracket
說好不提…	bracket
說好不提XXX	bold
說好不提261（話）	bracket
說好不提261	link_title
說好不提	bracket
說到做到	bracket
說個笑話	bold
誤操作	link_title
語言學板	link_title
語畢，哄堂大笑	bracket
語畢 哄堂大笑	title
誘姦	bracket
誓死捍衛板規九	bracket
認真發廢文	bracket
認真就輸了	link_title
認為	bracket
認同	bracket
詹姆士	bracket
該注意什麼？	link_title
該如何追女生	bracket
詩詞+寫作業	bold
詩板	link_title
試閱	bracket
試用文	bracket
詞/hiimlive	bold
詐死	bracket
註冊認證	link_title
註冊單	link_title
許願文	bold
設靜	link_title
設了	bracket
訟棍事件	link_title
訟棍	link_title
記者正確	bracket
記者快來抄	bold
記者上ptt抄新聞	link_title
記者	link_title
記得發好發滿呀～	bracket
記得寫信告訴我今天海是什麼顏色	bracket
討狐戰役	bracket
討推文	link_title
討拍文	link_title
討噓文、欠噓、成全你、偏不噓、幫噓、我先、跟上	link_title
討噓文	link_title
討噓	link_title
解職	bold
解夢	bold
覽趴震之亂	link_title
覽趴好	bracket
覺青	link_title
覺醒青年	bracket
覺醒公民	bracket
覺醒	bracket
覺得大家用歧視的眼光看她	bracket
覺得事情是真的	bracket
視訊追求	bold
視聽劇場	link_title
要變成 XX 的形狀了	bracket
要求對手主動退選	bracket
要有同理心	bracket
要是這篇被推爆我就…	bracket
要救六大派，來大都找我吧	bracket
要拿榔頭打爛她送的iPad	bracket
西部試閱失敗事件	link_title
西部板	link_title
西部娘	bracket
西甲大戰	link_title
西洽版	link_title
西洽活躍板友	title
西洽板	link_title
西洽	link_title
西斯點	bracket
西斯版	link_title
西斯洨狐	bracket
西斯板大甲請吃雞排	link_title
西斯板	link_title
西斯感謝祭	link_title
西斯廢文夜	bracket
西斯廢文之夜	link_title
西斯國際化	bracket
西斯七武海、西斯王下七武海	title
西斯七武海	link_title
西斯56	link_title
西斯	link_title
西摳	link_title
西恰版	link_title
褫奪公權半年	bracket
複雜的防衛機制	bracket
複製文	link_title
複習	title
製作人	bracket
裡洽版	link_title
裡洽板	link_title
裡洽(AC_In)	link_title
裡洽	link_title
裝熟	link_title
裝文青	link_title
裝可愛	bracket
裝什麼可愛	bold
補血、幫補血、先補血、聖光術	title
補血	link_title
補推	bracket
補噓	bracket
補刀文	link_title
補個幹	link_title
裏洽	link_title
被雷到	bracket
被閃到	bracket
被自殺	link_title
被看破手腳	bracket
被盜帳號	link_title
被無縫接軌	bracket
被水桶	bold
被推爆我就附圖	bracket
被捏了	bracket
被嗆了嗚嗚	bracket
被刪	link_title
被分屍了	bracket
被你勉強得逞的女生你做的快樂嗎	bracket
被人告	link_title
衰敗遊龍	bracket
表特版	link_title
表特板禁止	link_title
表特板	link_title
表特	link_title
表妹	bracket
衣服板	link_title
衝紫爆事件	link_title
衛斯理板	link_title
街亭文	bold
街亭很難守	bracket
街亭	link_title
行為垃圾的政客不分藍綠政黨都有	bracket
行政中立、依法行政、查無不法、謝謝指教	bracket
蠹魚王	bold
蟹Seafood	bracket
螃蟹王，寄居王	bracket
螃蟹王	bold
螂性	bold
蝦（子）王	bracket
蜀漢老麵	bracket
蛋蛋的哀傷	link_title
蛋蛋受難記	bracket
蛋蛋	bracket
蛆蛆（藍蛆、病畜）	title
蛆蛆	link_title
處男	link_title
處理情緒失控	bracket
處女	bold
處刑	bracket
虎航空姐	bracket
虎爛版	link_title
虎哥事件	link_title
虎哥	bold
蘿莉正太板	bold
蘇美苗博雅因母豬教話題約戰事件、AA之亂	link_title
蘇美苗博雅因母豬教話題約戰事件	link_title
蘇美戰神	link_title
蘇美	link_title
蘇憶芬	link_title
蘆洲火車站	link_title
藏頭文	link_title
藏頭	link_title
藏獒	bold
藏書界竹野內豐	link_title
藏書王	bold
藍蛆	link_title
藍綠	link_title
藍瘦香菇	bold
藍爆	link_title
藍波	bold
藍染王	bracket
藍染	bracket
藍寶	bold
藍「爆!」	link_title
薪水板	link_title
薪水小偷	bracket
薪水小倫	link_title
蕭葉雯	bracket
蔡逼八	link_title
蔡正元	link_title
蓮子圖	link_title
葡京娛樂城	bracket
葉姵文	bold
葉元成台	bracket
葉佩雯	link_title
葉佩文	bracket
萬神殿的掃地工	bracket
萬神殿	link_title
萬用三熊圖	bold
萬年板主	bracket
萬人響應，萬人到場	link_title
萬人響應，一人到場	link_title
萬人響應無人到場	bracket
萊納‧布朗	bracket
菲律賓船射殺台灣漁民事件	link_title
菲律賓王	bracket
菲律賓海巡船隻射殺台灣漁民事件（含便當文事件）在ptt	link_title
菲律賓海巡署射殺台灣漁民事件	link_title
菲律賓射殺台灣漁民事件	link_title
菲律賓公務船射殺台灣漁民事件	link_title
華肯	bracket
華生你突破盲點了、華生你突破盲腸了	title
華生你突破盲點了	bold
華生你突破盲腸了	bold
菜鳥	bracket
菜逼八	link_title
菜花	link_title
菜市場名	bracket
菊花	bracket
菁英老大哥集團	bold
莫名奇妙	bracket
莎朶霓	bracket
莎拉之亂	link_title
莊園大師	link_title
草不可避	bracket
范范	link_title
范植偉是什麼咖啊！演個海角七號就跩到天上去了！	bracket
英雄聯盟板	bold
英文老師常請假	bracket
英國吃屎	bracket
苦瓜妹	bracket
若對手柯文哲MG149帳戶被發現有任何瑕疵，柯也應退選。	bracket
苗栗小五郎	link_title
苗栗國	bracket
花椒記麻辣鴛鴦鍋	bracket
花果山	bracket
艾珮珊	bracket
色情	link_title
航運板（Navigation）	link_title
航空板（Aviation）	link_title
航空板	link_title
航空	link_title
舒服文（XXX令人舒服）	link_title
舒服文	link_title
舒服XXX	bracket
舒服	bracket
臺語王	bold
臺灣的魯蛇	bracket
臺灣王	bold
臺灣每人平均資產七百萬	bracket
臺灣歷史王	bold
臺灣平均薪資每月五萬	bracket
臺灣希望群星館	link_title
臺灣大學	link_title
臺灣	bracket
臺山湯告魯斯	bracket
臺大人生學程	bracket
臺中不意外	bracket
至於你信不信，我反正信了	bracket
至今逍遙法外	bracket
臭酸宅	link_title
臭臭	bracket
臭肥宅	bold
臭死	bracket
臭宅	link_title
自豪	bold
自自的	bracket
自自犬犬	link_title
自自冉冉	link_title
自自	bracket
自肥	bracket
自稱	bracket
自由時報	link_title
自殺文	link_title
自殺	bracket
自掛東南枝	bracket
自從我首頁改成 hao123 後 再也沒被綁架過了	bracket
自己生病、女兒生病、女兒旅遊、要接女兒、老婆生日、老婆結婚紀念日、家裡電器壞了、公會上課	bold
自己沒錯，都是別人的錯	bracket
自己受到歧視跟詛咒	bracket
自己人	bracket
自宮	bracket
自動販賣機爆走	link_title
自介文	link_title
自介	bracket
臨時聊天板	bold
臨時心情抒發板	bold
臧霸	bracket
臣又	bracket
臣亮言	bracket
臉被打腫的釣客	bracket
臉書粉絲頁	link_title
臉書ptt粉絲團	link_title
臉很綠的豆子是什麼？   Ans：綠豆	bracket
膝蓋軟了	bracket
膝蓋中箭	bracket
腿了	link_title
腹推	bracket
腳趾推	bracket
腦補	bracket
腦殘	bracket
腥伯	bold
脾氣不好	bold
能量	bracket
能上表特	bracket
胸推	bracket
胖胖	bold
胖子	bracket
背影	bracket
肯德雞像屎大大	link_title
肯德基像屎大大	bracket
肩推	bracket
肥皂錢和瓦斯費	bold
肥宅會跳肚皮舞有加分嗎？	bracket
肥宅會瞬間移動有加分嗎	bracket
肥宅會彈鋼琴有加分嗎？	bracket
肥宅會做菜有加分嗎？	bracket
肥宅文	link_title
肥宅悲歌 QQ	bold
肥宅悲歌	bold
肥宅很幽默有加分嗎？	bracket
肥宅就直接0分了	bracket
肥宅做什麼都扣分	bracket
肥宅XXX，有加分嗎？	bracket
肥宅3公里跑12分鐘有加分嗎？	bracket
肥宅	link_title
肥仔	bracket
股票版	link_title
股票板	link_title
股板	link_title
股市總司令	bold
肛門榨甘蔗	link_title
肛肛好	link_title
肛肛	link_title
肚臍的英文你知道嗎？	bracket
肚臍推	bracket
肚子推	bracket
肘擊胸部	bracket
肘擊她奶子（肘擊胸部）	title
肘擊她奶子	bold
肘擊大奶子	bracket
肘擊XX	bracket
肉搜	link_title
聽首歌吧 …	bracket
聽海哭的聲音	bracket
聽海	bracket
聽朋友說	bracket
聯合重工	bold
聯合報、聯合重工	title
聯合報	link_title
聯合不意外	bracket
聚眾癱瘓看板正常運作處理規則	link_title
聖路易紅雀隊板	link_title
聖戰	bracket
聖安東尼奧馬刺球隊(San Antonio Spurs)隊版	bold
聖光術	link_title
聖人模式	bold
聖人	bracket
聊天室滑起來！等等我一個一個檢查，沒滑起來一個一個拖出來打斷鼻樑！	bracket
聊天室	link_title
而非 ptt 特別用的，就不特別標示	bold
考試都考100分	link_title
老闆雞排、珍奶一分	bracket
老虎	bracket
老皮	link_title
老木	bold
老婆走不出舊戀情就跟老公結婚，不是回收是什麼??	bracket
老女人	bracket
老司機之亂	link_title
老司機	link_title
老人、女人、老女人	bracket
老二	bracket
老ㄙ	bracket
耀揚哥	bold
翻譯	link_title
翻多	bold
習近平稱帝	bracket
習包子之亂	link_title
義軍	link_title
義美食品	link_title
義美	link_title
群組長	link_title
群組	link_title
美音online	bracket
美軍1945年在長崎.廣島分別投下了一份聯合報	bracket
美豔人妻愛撫妻	bold
美術站長	link_title
美艷人妻靚妹版花愛撫妻	bracket
美粧板	link_title
美江網羅電音夜	bracket
美江生氣了	bracket
美江沒有極限	bracket
美江撿鑽石	link_title
美江在ptt	link_title
美女荷官在線	bracket
美堂蠻與她的快樂夥伴	bracket
美國阿爸人	bracket
美國表示：	link_title
美國	link_title
美乃滋	bracket
美の偽娘	bracket
羅禮士	link_title
罷免	link_title
罰單(罰單停權)	bold
罰單	link_title
置底閒聊文	bracket
置底歐洲區	link_title
置底曬卡區	bracket
置底文章	bold
置底文	link_title
置底	link_title
缺乏業務能力	bracket
繼承好友陣線的遺志，	bold
繞過大師	bold
繞過rar	link_title
繁體中文20	bold
總監	link_title
總分類	title
縣民	link_title
練蠱	bracket
編輯文章	link_title
編輯原始碼	link_title
編輯入門和建議	link_title
編輯	link_title
編寫規則	link_title
線蟲	title
線上烤肉	link_title
綿木蜜雪兒	bracket
綽號	link_title
綺想世界	bracket
網頁版	link_title
網軍帳號進入ptt	link_title
網軍	bracket
網路訴訟資詢板	link_title
網路訴訟事件	link_title
網路訴訟	link_title
網路訟棍事件	link_title
網路訟棍	link_title
網路作家版	link_title
網購板	link_title
網羅	bracket
網球板	link_title
網友	bold
網內互打免費	bracket
維大力	bracket
維修	link_title
綠豆糕	bracket
綠蟑螂	link_title
綠綠的	bracket
綠綠	bracket
綠皮卡不要亂用	bracket
綠皮卡	bracket
綠爆以上事件列表	link_title
綠爆	link_title
綠扁帽大	bold
綠帽	bracket
綠吱	bold
綠光罩頂	bracket
綠光的事	bracket
綠「爆!」	link_title
統神？是你？？	bracket
統神	link_title
給開司一罐啤酒	link_title
給開司一罐…	bracket
給開司…	bracket
給鄉民問嗎？	bracket
給她吃肉棒	bracket
給xx一條麻繩	link_title
給XX一條麻繩讓XXX自盡吧	bracket
給XX一條麻繩	bold
給Gasol 一條繩子！	bracket
結束了	bracket
結拜吧」	bold
結哥	bold
終於戰勝黑眼圈	bracket
紳士（ㄅㄧㄢˋ  ㄊㄞˋ）	bracket
細川	bracket
累了嗎？聽首歌好嗎？	bracket
紫色小魚花園	link_title
紫色噴霧	bold
紫爆活動	bracket
紫爆	link_title
紫「爆!」	link_title
素肚	bold
純推不下	bracket
純推	bracket
紐大校長見馬英九　以擁抱代替握手	bracket
紅襪板	link_title
紅的明顯	link_title
紅的喜氣	link_title
紅爆	link_title
紅明顯	bold
紅心點	bracket
約跑	link_title
約炮	bold
約戰	bracket
約克羊陣線	link_title
約克羊(	bold
約克羊	bold
系邊	bold
系統過載	link_title
系統警察	link_title
系列文	link_title
糟糕物	link_title
糟糕島	bold
糟糕	link_title
糟了，是生殖器官	bracket
糟了，是世界奇觀	bracket
糟了	bracket
糗爺	bold
精靈王	bold
精釆	bracket
精蟲衝腦	bracket
精華區	link_title
粉絲板	bracket
粉紅	bracket
米分系工女乃豆頁	bracket
簽名檔	link_title
簽到	bracket
簽下去	bold
箱民	bracket
箱子	bracket
箭頭測風向	bracket
箭頭	link_title
等待不到的事物	bracket
等待	bracket
等到我一無所有，他就跟我賭手賭腳	bracket
筆記	bracket
筆戰	link_title
第四屆風雲人物票選	link_title
第四屆風雲人物票	link_title
第四屆批踢踢流行語大賞	link_title
第四屆ptt風雲人物票選	link_title
第四屆pttfamous（風雲人物票選）	link_title
第四屆pttfamous	link_title
第四屆PttFamous票選	link_title
第四屆 PttFamous（風雲人物票選）	link_title
第四屆 PttFamous（風雲人物投票）	link_title
第六屆 PttFamous（風雲人物投票）	link_title
第五屆風雲人物票選	link_title
第五屆PTT風雲人物投票	link_title
第五屆PTT風雲人物	link_title
第五屆 Ptt風雲人物投票	link_title
第五屆 PttFamous（風雲人物投票）	link_title
第二屆流行語大賞	link_title
第二屆批踢踢流行語大賞	link_title
第二屆ptt風雲人物票選	link_title
第二屆ptt流行語大賞	link_title
第二屆pttfamous票選	link_title
第二屆PttFamous（風雲人物投票）	link_title
第二屆 PttFamous（風雲人物投票）	link_title
第二屆	link_title
第三屆風雲人物票選	link_title
第三屆流行語大賞	link_title
第三屆批踢踢流行語大賞	link_title
第三屆ptt風雲人物票選	link_title
第三屆pttfamous	link_title
第三屆ptt famous	link_title
第三屆PttFamous票選	link_title
第三屆PTT流行用語大賽	link_title
第三屆 PttFamous（風雲人物投票）	link_title
第三屆 PttFamous	link_title
第一次見面就攜帶ＫＹ和保險套並與該女鄉民見面	bracket
第一次見女網友該注意什麼？	bracket
第一次	bold
第一手電源	bracket
第一手天元	bold
第一手大元	bold
第一手五之五	bracket
第一屆流行語大賞	link_title
第一屆批踢踢流行語大賞	link_title
第一屆ptt流行語大賞	link_title
第一屆pttfamous投票	link_title
第一屆pttfamous	link_title
第一屆 PttFamous（風雲人物投票）	link_title
第一個之亂	link_title
第一人稱	bracket
第5屆風雲人物票選	link_title
第5屆風雲人物	link_title
第5屆批踢踢風雲人物票選	link_title
第4屆風雲人物票選	link_title
第4屆風雲人物的票選	link_title
第4屆ptt風雲人物票選中	link_title
第4屆ptt風雲人物票選	link_title
第4屆ptt風雲人物投票	link_title
第4屆pttfamous票選	link_title
第4屆PTT Famous	link_title
第4屆	link_title
第3屆ptt風雲人物票選	link_title
第3屆pttfamous票選	link_title
第3屆pttfamous	link_title
第3屆PttFamous票選	link_title
第3屆	link_title
第2屆流行語大賞	link_title
第2屆ptt風雲人物票選	link_title
第2屆ptt風雲人物投票	link_title
第2屆ptt流行語大賞	link_title
第2屆ptt famous	link_title
第1屆流行語大賞	link_title
第1屆ptt風雲人物投票	link_title
第1屆ptt流行語大賞	link_title
第1屆ptt famous	link_title
笨蛋	bracket
笨版	link_title
笨板表特化	bracket
笨板板規九、板龜酒	title
笨板板規九	link_title
笨板文	bracket
笨板並沒有板規九	bracket
笨板	link_title
符號	link_title
笑點	bracket
笑話版	link_title
笑話	link_title
竹野內豐	bracket
竹北車站	bracket
竟然想搶藍染王的生意	bracket
站長群	bold
站長會議	link_title
站長	link_title
站規	link_title
站外相關事物	link_title
站務顧問	link_title
站務警察	link_title
站內信聯盟	bracket
站內信箱	link_title
站內信yoyodiy	bracket
站內信+5000p	bracket
站內信	link_title
站內 500P	link_title
空軍招集令	bracket
空虛寂寞覺得冷	link_title
空白文	link_title
空手	bold
種花電信	link_title
種花不意外	bracket
秦楊板	link_title
秦國連百貨公司都沒有哪裡超越了	bracket
秦國沒有百貨公司	title
秦國有百貨公司？	bold
秦國有百貨公司嗎	link_title
秒買秒退	link_title
科科（ㄎㄎ、顆顆）	title
科科科科科	bracket
科科	link_title
科技版	link_title
私德太差	bracket
私人信件區	bracket
秀下限	bracket
禾斗禾斗	bracket
禁言	link_title
禁止重複推文	bracket
禁止人身攻擊、挑釁、歧視或引戰意味之言詞用語。	bracket
祭品文化	link_title
祭品文	link_title
祭品	bracket
神龍	bold
神魔之塔板	link_title
神釣手	bracket
神貓大	link_title
神貓	link_title
神豬	link_title
神說要有PTT 於是有了PTT	bracket
神經病（關電視）	link_title
神相簿	link_title
神犬柯黑	bracket
神父我有罪	bracket
神父	link_title
神機	bracket
神木	bold
神曲	bracket
神得到我就吞籃球架	bracket
神尼	bold
神圖	bracket
神器	link_title
神勇？	bracket
神人	link_title
神之卡	bracket
神串留名	bold
神、神人	title
祝福	bracket
社會亂源	bracket
社后文	link_title
社后	bracket
礦業法進度到哪了？	bracket
磁碟重組	bold
硬要	link_title
硬了	bracket
破麻、PUMA	title
破麻	link_title
破媌	bracket
破壞之王	link_title
研究所板	link_title
砍除帳號	link_title
砍掉重練	bracket
砍掉	bracket
矽谷	bracket
石沐凡澄清之亂	link_title
睪丸文	link_title
督割事件	link_title
睡菊	bracket
睡學生	bracket
睏哈星	bracket
眼睛	bracket
真香	bracket
真相	link_title
真的好想贏韓國	bracket
真的好想贏	link_title
真男人…咦…真女人才對	bracket
真男人	bracket
真歹笑	bracket
真是忍辱負重	bracket
真愛	bracket
真想撞豆腐自殺	bracket
真心祝福，你的故事很浪漫：）	link_title
真心祝福，你的故事很浪漫	link_title
真強者	link_title
真像一塊塊綠豆糕。	bracket
真der	bracket
看聯合報拿高分專欄	bracket
看笨版長知識	bracket
看笨板長知識	bold
看清楚反波波人士的真面目	bracket
看板警察局	link_title
看板警察	link_title
看板位置	link_title
看板人氣	link_title
看板人數、看板人氣	title
看板人數	link_title
看板	link_title
看性版學姿勢	bracket
看到xxx就直接END	bracket
看似有道理，但實際上什麼也沒講	bracket
省錢板	link_title
省衛生紙錢	bold
相信我之術	bracket
相似帳號	link_title
直銷	link_title
直到我的膝蓋中了一箭	link_title
盲生 你突破華點了！	bold
目前由	bold
目前已知的陣線總人數約460餘人	bold
監督	bracket
盡力把推動讓八卦板變得更搞笑、有趣、歡樂	bracket
盜p幣事件	link_title
盜1.4億批幣事件	link_title
盒盒家族	link_title
盒盒可愛 <3	bold
盒盒	link_title
盒三小	bold
皇民吱	bracket
皇民	link_title
百問百答	link_title
白賊	link_title
白的明顯	bracket
白痴	bracket
白海豚	link_title
發雞排	link_title
發錢文	link_title
發錢	bold
發車	bracket
發語詞	link_title
發覺………	bracket
發表文章	bold
發生性關係	bracket
發現不論哪個姑娘的名字，後頭加個“.rmvb”或者“.avi”，看上去頓時就有了 一種別樣的曖昧與風騷	bracket
發文限制	link_title
發文附圖	bold
發文門檻	link_title
發文都有聲音	bracket
發文資格	link_title
發文要附圖	bracket
發文與推文限制	link_title
發文權限、發文限制	title
發文權限	link_title
發文不附圖，此風不可長	link_title
發文不附圖此風不可長	link_title
發文	bold
發完實況文板規	link_title
發卡	link_title
發動募款陳男	bracket
登出	title
登入畫面	link_title
登入次數、上站次數	title
登入次數7000以上鄉民列表	link_title
登入次數	link_title
癌症重症兒童中途之家	bracket
瘦宅	bracket
瘟腥	bracket
瘋狂做愛	link_title
痞踏辣	bracket
病魔加油	link_title
病畜	bracket
疊印記	bracket
當年我每回翻開課本，腦袋裡就先告訴自己 這是戰場，我是來拼命的	bracket
當你個板	link_title
畫面	bracket
畜牲	bracket
留言	bold
男生真的要好好保護自己	bracket
男板	link_title
男女版	link_title
男女板	link_title
男女	link_title
男、女朋友	bracket
甲級動員	bracket
甲甲	link_title
甲板隔空水桶事件	link_title
甲板隔空水桶	link_title
甲文	link_title
甲子權亂	link_title
由於需要回台灣。
回台灣之後手邊沒有電腦	bracket
由於我明年要進軍二輪車界組一個車隊,沒有多餘
時間上來ptt這邊推圖,並且由於這個運動對我說是
沒有任何危險性的,但是對於車手來說是具有高度危
險性的運動.
因為我是總領隊,必須要考慮到很多問題,沒有多餘的
時間來思考其他的事情來娛樂鄉民.
然後ac4r只是我車隊的名稱並非是我在這裡出名的原
因,我在西斯版出名這當初的原因是我真的很無聊,在
玩推圖之後然後莫名其妙就出名了.
所以在2013/12/24號過後,這個帳號只剩下看文章的功
能,並不會做任何的事情,以上我最後發言給鄉民的聖誕
禮物.
我這個人沒有任何夢想,我只會實現別人的夢想.	bracket
由於K島匿名性高，	bold
田ㄙ	bracket
用麵線上吊	bracket
用肛門榨甘蔗	bold
用ptt看天下	bracket
產官學宅鄉婉	bold
生理寶健	bracket
生理保健	bracket
生活娛樂館 > 心情小品集	bracket
生活娛樂館	link_title
生活娛樂群組	link_title
生活在鬼島	bracket
生氣	bold
生日	title
甜+辣	bracket
甘道夫之亂	link_title
甘蔗姊姊	bold
瓶中信	bracket
瓦哥，是你？	bracket
瓦哥	link_title
瓦力爆錶	bracket
瓦力學之父	bracket
瓦力	bracket
瓦倫達效應	bracket
瓦倫達	link_title
理財規劃板	link_title
理由伯	bracket
理性中立選民	bold
理性中立	bold
現實名人	link_title
現實	link_title
現場轉播文	bold
現在的工作好不好	bracket
現在放棄，寒（暑）假就開始惹	title
現在放棄的話，比賽就結束了	bracket
現在我跟一個女生正在旅館裡面，女生剛剛去洗澡了，請問西斯板友們我現在該怎麼辦?	bracket
現在急用	bold
現在人工智慧這麼進步了喔！	bracket
珮珊姊姊	bracket
玻璃心碎滿地	bracket
玻璃心發作	bracket
玻璃心	bold
玩法	bracket
玩家和製作人的對立	link_title
玩家	bracket
王王冷	bold
王浩宇	link_title
王建民的前隊友XXX	bracket
王建民板	link_title
王仁甫	link_title
王下七武海	bracket
獵人知識+	bracket
獵人版	link_title
獵人板	link_title
獵人	link_title
獅魯閣	bracket
猿魯閣	bracket
猶他爵士板	link_title
猜謎文	link_title
猜不透是什麼動物很刺激	bracket
狼煙	bracket
狼性	bracket
狗鼻哥	link_title
狂秀下限	bracket
狂新聞	bold
狂戰士模式	bracket
狀態	link_title
犬犬	bracket
牽手護肥宅	bracket
牽手護XX	title
特約作家朱子	bracket
特性	bracket
特定版友緊抓著球員可受公評、版友言論免責、版規也禁止"討論版友"、加上spurs2120版主保護傘，繼續大肆攻擊	bold
牡蠣迷	bold
牡蠣	bold
牛魯閣開張了	bracket
牛魯閣時間	bracket
牛魯閣	link_title
牛頓當時就是被聯合報打到頭才會發現地心引力	bracket
牛肉之亂	link_title
牛牛不意外	bracket
牙牙卡卡	bold
版面	link_title
版規	link_title
版主spurs2120則明顯袒護某些版友，導致版上三不五時便會有看不下去的刺迷大動作強調不滿。	bold
版主	link_title
版上都乾了	bracket
版上水很多	bracket
牆頭草	bracket
爸爸開始對她很兇	bracket
爸媽囧很大－ptt是什麼	title
爸媽囧很大	bold
爸媽冏很大-ptt是什麼	link_title
爬文	link_title
爪爪	link_title
爪二	bracket
爛記者	bracket
爛兵683T瘋狗人渣秦豐鍾志偉,犯賤!去死!幹!	bracket
爛兵 683T 人渣賤狗張順瑋	bracket
爆走金魚	bold
爆裂魔法	bold
爆炸到裂開	bracket
爆文	link_title
爆卦	bracket
燻雞fat pork	bold
營養師版	link_title
燒燬	bracket
燒毀同性戀靈的網羅	bracket
燒毀	bracket
熱點	bracket
熱門看板	link_title
熱門板面	link_title
熊貓豆腐	bracket
照片	link_title
煞氣ㄟ骨科	bracket
然後瘋狂做愛	bracket
然後他就死掉了	bold
焦安溥	bold
無雷	bracket
無重大八卦	bracket
無腦	bracket
無縫接軌、吳鳳接鬼	title
無縫接軌	bracket
無縫	bracket
無病呻吟	bracket
無界塾	bracket
無法引發八卦討論明知故問	bracket
無意義推文#惡意噓文	link_title
無意義推文	title
無差別亂吐日	bracket
無卦	bracket
烏咪沒有犯罪	link_title
烏咪	link_title
為算我一票	bracket
為何我跟幾個同學出去吃飯後，下次就不約我了？	bracket
為何XX地點不蓋球場	bracket
為什麼說好不互噓的好友陣線會有G軟?	bracket
為什麼要放棄治療？	link_title
為什麼要放棄治療	bracket
為什麼後驛一帶的路名都是中國省份？	bold
為什麼女生都看不起他	bracket
為什麼圍棋要分男女比賽？	bracket
為什麼你們常在網上打『廠廠』啊？	bracket
為什麼今天圓山站特別臭？	bracket
為什麼XX企業很有錢不組球隊	bracket
為了保障言論自由，你要提供踢爆文屬於不實虛構，才可以刪文。	bracket
炸裂文	link_title
炸裂、炸裂文	link_title
炸裂	bold
炫耀	bracket
火蠅人者	bracket
火星文	link_title
灌水	link_title
瀏覽器版	link_title
濫用爆卦	bracket
濫情	bracket
濠洨	bracket
激怒	bold
澳門首家線上賭場上線啦	bold
漳和國中	title
漫長的戰鬥終於畫下休止符	bracket
漫畫吐槽板	link_title
漫吐版	link_title
漫吐板	link_title
漫吐	bracket
漢堡王	bracket
漁二代	bold
滿滿的大．平．台！	bold
滿懷感激的正拳	bracket
滿懷感激地xxx也要支持中華隊	bracket
滾回去	bracket
滾動	bracket
滷蛇	bold
滯台皇民	bracket
滯台支那人	bracket
滑起來	title
滑幹先知	bracket
溫馨笨版	bracket
溫馨	link_title
溫水煮青蛙	bracket
溫柔的人，都值得幸福	bracket
溫拿	bracket
準確度	bracket
準備在北韓發現大規模毀滅性武器	bracket
湯姆克魯斯板	link_title
湖中女神	link_title
渴霧享樓	bracket
港漫	link_title
測風向	link_title
清淨	bracket
清流	bracket
淺藍爆	bold
淺綠爆	bold
深長 blow	bracket
深藍爆	bold
深度文	link_title
淡淡的哀傷、蛋蛋的哀傷	title
淡淡的哀傷	bracket
淡定紅茶事件	link_title
淡定紅茶、淡定哥、分手擂台	link_title
淡定	link_title
淑女 （ㄈㄨˇ ㄋㄩˇ）	bracket
涼宮春日與她的快樂夥伴	bracket
涉案停權	link_title
消波塊	link_title
消歧義	link_title
浸水桶	bold
海鳥	bold
海釣王	bracket
海賊王板	link_title
海賊板	link_title
海盒	bold
海產王、養殖漁業王	bold
海水退潮就知道誰沒穿褲子游泳	link_title
海水退潮	link_title
海景第一排	link_title
浮竹王	bold
浪費才能	bracket
浪女跟貞女	link_title
流行用語	link_title
流行	bracket
流水兒	bold
流氓	bracket
洽XXX板	bracket
活水來冊房主人	bold
活動部	link_title
活動站長	link_title
活動中心	link_title
洪仲丘事件在ptt	link_title
洪仲丘事件	link_title
洩露隱板資訊	bracket
洨狐	bold
津島梨子	bold
洗錢仔	bold
洗衣機	bracket
洗腦	bracket
洗白	bracket
洗版	link_title
洗澡（洗臉）刷牙睡覺去吧	bracket
洗洗睡啦	bracket
洗洗睡吧	bracket
洗洗睡了	bracket
洗洗睡	link_title
洗板	link_title
洗數據	bracket
洗上站次數	bracket
洋蔥文、加了洋蔥	link_title
洋蔥文	link_title
洋基板	link_title
泰皇	bracket
泰國國家石油股份有限公司	bracket
注音文	link_title
泣板	bold
波波	link_title
波卡之亂	link_title
泡麵怎麼吃才健康?	bracket
法院認證的政治垃圾	bracket
法院認證的嫖妓男	bracket
法院認證的xx	title
法院認證的XXX	bracket
法院認證	bracket
法院是國民黨開的	link_title
法西斯板	link_title
法西斯	link_title
法律認證XXX	bracket
法律問題	link_title
法律	link_title
法務站長	link_title
治療	bracket
治病撿鑽石	link_title
沙發	bracket
沙威馬	link_title
沙威瑪	bold
沒，被盜	title
沒驗票沒真相	bracket
沒錢葬父	bracket
沒錢	link_title
沒辦法啊，陸客不來了，你我都受害。	bracket
沒辦法啊，你我都受害	bracket
沒辦法啊 住在鬼島 五五六六得第一  你我都受害	bracket
沒辦法啊 住在鬼島 xxxxxxx 你我都受害	bracket
沒辦法啊	bracket
沒辦法住在鬼島	bracket
沒穿褲子	bracket
沒空	link_title
沒有臺灣價值	bracket
沒有極限	link_title
沒有性慾的狀態	bracket
沒有BBS我活不下去阿	bracket
沒有 XXX，失敗	bracket
沒救了~砍掉重練吧	bracket
沒救了	bracket
沒想到我會在死人面前說謊吧	bracket
沒女友	bracket
沒圖沒真相	link_title
沒同理心	bracket
沒人會戰的另一組	bracket
沒事兒！沒事兒！	bold
沒了姆咪該怎麼活下去	bracket
沒56ID還敢問56的卦	bracket
決鬥文	bold
決鬥吧	link_title
決鬥	bracket
汲汲營營	bracket
汪踢板	link_title
汪踢	link_title
汪梯	link_title
池上戶彩	bracket
江小辣影片事件與鎖文之亂	link_title
江小辣影片事件	link_title
江小辣	link_title
汝不悅勿視	bracket
求神	link_title
求真相	bracket
求檔文	link_title
求圖	bracket
永遠離開mentalk版	bracket
永久水桶	bold
水精靈	link_title
水球	bold
水泥預拌車啟動	bracket
水母	link_title
水桶某特定版友三週	bold
水桶哥	bold
水桶	link_title
水利系室友	bracket
氣到發抖	link_title
民進黨推行的事物皆為台灣價值的體現	bracket
民視板	link_title
民用航空運輸管理規則	bracket
民族	link_title
毫無建樹	bracket
毫無回應，就只是個長老	bracket
毫無反應，就只是個XX	bracket
毫無反應，就只是NPC	bracket
毫無反應就只是個XX	title
比較好	bracket
比爾陳	link_title
每日發文	link_title
每日任務(1/1)	link_title
每日任務	link_title
每日	link_title
每個消波塊內，都有一個靈魂	bracket
每人平均有一顆睪丸	bracket
母豬騎士來喔~	bracket
母豬母豬，夜裡哭哭	bracket
母豬母豬夜裡哭哭	bracket
母豬板	bracket
母豬文	link_title
母豬教進攻女板之亂	link_title
母豬教殉教事件	bracket
母豬教教徒	bracket
母豬教徒	link_title
母豬教出征事件	bracket
母豬教主	bracket
母豬教	link_title
母豬就應該給豬幹	bracket
母豬之亂	link_title
母豬	link_title
母湯	link_title
母X	bracket
段譽	bracket
段木香菇一日體驗營	bold
殲滅支那人跟搞統戰的五毛	bracket
殉教	bracket
死魚魚	link_title
死魚推我只好噓了	bracket
死魚噓我只好推了	bracket
死魚	bold
死阿陸	bracket
死神王	bold
死神板	link_title
死忠	bracket
死亡之握、馬賽傳奇	title
死亡之握	link_title
歷史老師常請假	bracket
歷史板	link_title
武漢肺炎板	bold
正要…的時候，就醒了	bracket
正義魔人、假道學	bracket
正義魔人	bracket
正確的	bracket
正直與善良都回來了	bracket
正直與善良又要不見了	bracket
正直和善良會回來	bracket
正晶限時批	bracket
正晶文	link_title
正常能量釋放	bold
正妹板主	bracket
正妹之亂	link_title
正妹	link_title
止兀體	link_title
歐陽姊妹在八卦板	title
歐陽妮妮	link_title
歐洲王	bracket
歐洲客家人	bracket
歐洲人	link_title
歐巴馬	bracket
歐印	title
歐兔板	link_title
歌詞文	link_title
歌曲	bracket
欺負長ID	link_title
欺善怕惡	bracket
欸～可以幫我拿我的內褲一下嗎？我忘了拿	bracket
欲相姦無	bracket
次等人	bracket
次元切割刀	bold
次元刀	bold
欠噓	bracket
檢舉魔人	bracket
檢舉達人	bracket
檢舉王是地方的媽媽？	bracket
檢舉王	link_title
檢舉機(雞、姬)	bold
檢舉板	link_title
檢舉姬	bracket
橘子	bracket
模板:關鍵字之亂	link_title
標題藏頭文	bracket
樓層（樓上、樓下、幫蓋、電梯向下）	title
樓層	link_title
樓主好人一生平安	bold
樓主	link_title
樓下雨狗	bracket
樓下是XX嗎	link_title
樓下幫補	bracket
樓下幫噓	bracket
樓下yoyo大師	bracket
樓下hy	bracket
樓下ChinLan	bracket
樓下 obov	bracket
樓下	bracket
樓上胃口真好	bracket
樓上的數學老師常請假	bracket
樓上張爸	bracket
樓上口味重	bracket
樓上你好糟糕	bracket
樓上中肯	bracket
樓上	link_title
樂透	bold
榮譽版主	bracket
榮尼王	link_title
業配文	link_title
楊醫美	bold
楊過段譽	bracket
楊又穎自殺事件在PTT的影響	link_title
楊伊湄	link_title
楊主播	link_title
森77	link_title
棒球版	link_title
棒球板（Baseball）	title
棒球板主崩潰事件	link_title
棒球板	link_title
棒球	link_title
棒棒	bracket
棋靈王	bracket
棋國	link_title
梭哈	bracket
梗，	link_title
梗。	link_title
桶神	bracket
桶二	link_title
桌遊板	link_title
根本XX	bracket
根本	bracket
柯黑	bracket
柯韓糞	bracket
柯糞	link_title
柯學家	link_title
柯P失言	bracket
柯P	bracket
查詢個人資料	link_title
查詢	link_title
查理	link_title
查無不法，謝謝指教	title
查水錶	link_title
查水表	link_title
查榜	bracket
查你IP	link_title
查你 IP	bracket
查IP	link_title
查 IP	bracket
某樓你突破盲點了	bracket
某業務單位	bracket
柏油	bold
架空歷史板	link_title
架架架架…	bracket
林奕含事件	link_title
板龜酒	bracket
板面	link_title
板規四	bracket
板規六	bracket
板規九	bracket
板規	link_title
板花愛撫妻	bracket
板聚	title
板皇條款	bracket
板橋板	link_title
板標串連推齊	link_title
板標串連	link_title
板標	link_title
板服	link_title
板工	link_title
板名推齊運動	link_title
板名推齊	link_title
板友名單	bold
板友	link_title
板務管理	link_title
板主選舉	link_title
板主板	bracket
板主是我的了	bracket
板主帶頭發廢文	bracket
板主	link_title
東興烏鴉-耀揚哥	bracket
東海學生作業事件	link_title
東泉辣椒醬	title
東東事件	link_title
東方閃電	bracket
東方神秘力量	bracket
東南亞糞島	link_title
東南亞大使	bracket
東北三寶	bracket
東仙	bracket
杜鵑颱風颱風假在PTT	link_title
杜老爺	bracket
杜老大	bracket
杜奕瑾	link_title
李組長（fuunshing）	title
李組長眉頭一皺，發覺案情並不單純	bold
李組長眉頭一皺，發現事情並不單純	bold
李組長眉頭一皺，發現事並不單純	link_title
李組長眉頭一皺	bracket
李組長	link_title
李星	bracket
李宗瑞淫照事件	link_title
李宗瑞淫照	link_title
李宗瑞公布淫照事件	link_title
李宗瑞	link_title
李姓中壢選民	bold
李嚴系	bracket
李亦伸（糗爺）在ptt（LYS、亦伸文）	title
李亦伸	link_title
本魯蛇	bracket
本魯	bracket
本蛇	bracket
本臭宅	bracket
本臭	bracket
本肥宅	bracket
本肥	bracket
本票	title
本板清流	bracket
本板不歡迎自介	link_title
本日最中肯	bracket
本文鎖定	bracket
本文章已被吃掉	bracket
本文章已被刪除	bracket
本公主的回合 抽牌	bracket
本公主	bracket
本來就是這樣，所以發生這種事不意外	bracket
本來XXX也是XXX的，直到膝蓋中了一箭	bracket
本來	bracket
本佛	bracket
本人為了社會和諧，暫時不表演自含懶叫	bracket
未看先猜樓下email	bracket
未看先猜樓上fleeaaa	bracket
未看先猜樓上XXX	bracket
未看先猜是nothisman	bracket
未看先猜三寶	bracket
未看先猜一樓推XXXX	bracket
未看先猜一樓fleeaaa推未看先猜	bracket
未看先猜_____	bracket
未看先猜XXX	link_title
未看先猜	link_title
未看先拆	bracket
未檢附溝通記錄	bracket
未X先X	bracket
期末自殺潮	bold
期末自殺吼～	bracket
期末考又到了	bracket
期中自殺潮	bold
朝聖文	link_title
朝聖推文	link_title
朝聖	link_title
服貿討論板	link_title
服貿爭議	link_title
服貿板	link_title
朋友就是你自己	bracket
朋友啊	bracket
有雷	bracket
有雞雞先扣分	bracket
有閃光	bracket
有趣但錯誤	bracket
有話就直說的ACGN討論板	bracket
有股蛋蛋的哀傷	bracket
有股淡淡的哀傷	bracket
有笑有推（有校友推）	title
有笑有推 畫面感十足	bracket
有笑有推	link_title
有空	bracket
有種就衝著我來	bold
有神快拜	bracket
有無PTT最多登入次數與官階的掛?	bracket
有洞有加分	bracket
有洞先加分	bracket
有洞60分	bracket
有沒有鄉民很愛問誰打不打贏館長的八卦	bracket
有沒有洗澡不擦乾的八卦	bracket
有沒有殷允芃的八卦	bracket
有沒有塊陶啊的八卦	bracket
有沒有在圖書館長時間佔位的八卦？	bracket
有沒有台灣冷門科系在國外是熱門的八卦	bracket
有沒有公館長興街的八卦？	bracket
有沒有人首頁是 hao123？	bracket
有沒有七張梨的八卦啊？	bracket
有沒有一片車牌讓人又軟又硬的八卦?	bracket
有沒有h版主是小峱峱獨裁者的八卦	bracket
有沒有XX的八卦	link_title
有沒有XXX的八卦	bracket
有沒有XXX der八卦	bracket
有校友推	bracket
有曾經來我這裡消過費的客人 都知道我的做法 我的做人	bracket
有新信件還沒看	link_title
有效文章次數	link_title
有效文章	link_title
有捏	bracket
有情有義分隔線	bold
有建仔，有加分	bracket
有孔菜刀	bracket
有奶有加分	bracket
有失水準	bracket
有圖有真相	bracket
有加分嗎？	link_title
有加分嗎	link_title
有功夫無懦夫	bracket
有人說以後會有更多東西被屏蔽呀怎麼辦，靠北啊你們唬爛就沒關係啊	bracket
有人看我眼紅	bracket
有人毒害我	bracket
有下有推、純推不下	bold
有下有推	bracket
有一點ㄏ，又不會太ㄏ	bracket
有一種哀傷的感覺	bracket
有XX，有加分	bracket
月經文、週經文、日經文	link_title
月經文	link_title
月台	bracket
會有人說我戀棧嗎？我猜會	bold
會怎麼樣	bracket
最魯	bracket
最近雞排攤生意不好	bracket
最近覺得這句-->GG ININ很有梗，找到機會一直想推	bracket
最近死神變難看了	bracket
最經典之亂	link_title
最愛盜領P幣	bracket
最後頁	link_title
最後的結論	bold
最強的救援投手是誰？	bracket
最強	bracket
替代役不意外	bracket
替代役	link_title
曾經和陳偉殷對戰過的XXX	bracket
曹操生子當如？	bracket
書藉板	link_title
書板	link_title
更適合的板之亂	link_title
更多的xxx:http://raindog.pixnet.net/…	bracket
更多的XXX  http://raindog.pixnet.net…	bracket
更多更詳盡歌詞在※ Mojim.com 魔鏡歌詞網	link_title
曲藝士之亂	link_title
暴料公社	link_title
暴動	link_title
暱稱	link_title
暫時的	bracket
暗黑神龍	bracket
暗黑版神龍	bracket
暗罵	bracket
智乃騎士	bracket
景美建中事件	link_title
景嵐在我下面	bracket
普雷萬	bracket
普雷	bracket
晚點名	bracket
晚上十點以後不要打電話給我，因為我睡了	link_title
晚上7:00立法院群賢樓發動抗議	bracket
時候	bracket
時代	bracket
是馬謖失街亭吧？	bracket
是馬岱失街亭吧！	bracket
是要掩蓋什麼	bold
是想掩蓋什麼	bold
是在哈囉	title
是在哈佛？	bracket
是個軟體	bracket
是不是長得跟如花或許純美一樣	bracket
是不是要換下一份工作	bracket
是不是到公海了？	bracket
易建聯怒砍2分 幫助騎士勝巫師	bracket
明翰3C	link_title
明明2沒壞啊？	bracket
明天要跟女同事吃飯，該怎麼打開場面呢？	bracket
明天是辣個傳說中的下禮拜五嗎	bracket
明天就要期末考了，但是蹺課太多弄不懂，怎麼辦？	bracket
明天報到	title
昇天	bracket
早晨運動	bracket
日行一善	bracket
日經文	bracket
日本板	link_title
日本旅遊板	link_title
日月明功	bracket
日常系	link_title
日劇板	link_title
日久生情	bracket
旅外就是神	bracket
旅台就是神	bracket
施鹽	link_title
施旖婕／綜合外電報導	bracket
方能發言	link_title
方丈	bracket
斷開連線	bracket
斷水流大師兄	bracket
新頭殼之亂	link_title
新警察小武	bracket
新警察	bracket
新訓	bracket
新竹板	link_title
新竹圖王	bracket
新球	bracket
新歌	bracket
新德文	bracket
新店、烏來的朋友都超後悔投柯文哲	bracket
新宅男女神	bracket
新圖王	bracket
新北市在PTT	title
新北市	bold
新北不意外	link_title
新兵	bracket
新人歌手	bracket
新二二八事件	link_title
新228事件	link_title
文體	bold
文青式	bracket
文青	bracket
文組誤國	bracket
文組被自然組當廢物	bracket
文組害台灣	bracket
文組	bracket
文章數	link_title
文章太長了我直接按下END鍵	bracket
文章代碼	link_title
文章	link_title
文摘	link_title
文字獄	bold
文化	link_title
文具板	link_title
文人相輕	bold
數學老師時常請假	bracket
數學老ㄙ常請假	bold
數學老ㄙ常常請假	bracket
數字板	bold
數字	bracket
敵將討取	bracket
整個砍掉重練	bracket
整個城市都是我的化工廠	bracket
整個城市就是我的咖啡館	bracket
敲口i	bracket
敬禮！	bracket
散布猥褻圖片	bracket
教母文	link_title
教主obov	link_title
教主	bracket
救救台灣人，反黑箱服貿	bracket
救援成功	link_title
故障	bracket
故鄉	bold
政黑版	link_title
政黑板新增板主事件	link_title
政黑板	link_title
政黑	link_title
政經看民視	bracket
政治黑特板	bold
政治迫害	bracket
政治蟑螂	link_title
政治文	link_title
政治大學	link_title
政治垃圾	bracket
政治人物	link_title
政治	link_title
政大四姬	bracket
放雷	bracket
放開那隻貓，有種就衝著我來	bracket
放開那個女孩	bracket
放閃光	bracket
放過之亂	link_title
放過	bracket
放空	bold
放棄吧	bracket
放棄之亂	link_title
放大絕	bracket
放出大絕招	bracket
支那賤畜	bracket
支持	bracket
擬人化	bracket
擊潰丁守中	link_title
撿肥皂	link_title
撿子彈	bracket
撥接魂、飛鴿傳書	title
撥接魂	link_title
撞豆腐自殺	bold
撒花板	bold
撒花之亂	link_title
摳摳肉不用不用	bracket
摳屄	bracket
摩根費里曼這部又是演黑人	bracket
摩根費里曼很會演黑人	bracket
摩根費里曼在這部片演黑人	bracket
摩根費里曼只能演黑人	bracket
摩根在片裡是黑人，也是警察	bracket
摩根在片裡是黑人<-難道他有演過白人	bracket
搶頭香	link_title
搶老婆	link_title
搶篇文	link_title
搶到兩顆鑽石	bracket
搶po	bracket
搬進宿舍時 該注意什麼？	bracket
搬椅子	bracket
搜尋此頁面標題	link_title
搜尋找出	bracket
揪團	bracket
握手	bracket
換個ID推一樣的話	bracket
插頭事件	link_title
插座	bracket
提告	link_title
推齊	link_title
推爆	link_title
推文系統	link_title
推文測試拿 P 幣!!!	bracket
推文機器人	bracket
推文朝聖	link_title
推文投票統計系統	bold
推文+1，你就是互粉互讚不互噓的好友	bracket
推文	link_title
推投	bold
推娃版	link_title
推娃機器人	bracket
推娃板	link_title
推娃	link_title
推好玩的	bracket
推圖	link_title
推噓文	link_title
推啊 遊行上街頭，我先發5000份雞排	bracket
推倒她	bracket
推X樓	bracket
推XD	bracket
控制碼	bold
接龍推文	bold
掛號看精神科壓力會不會很大	bracket
排骨酥大	bold
排球	bracket
排毒	bold
排山倒海	bracket
掉在廣島的不是原子彈 是大同電鍋	bracket
捷運板（MRT）	link_title
捷運板	link_title
捐血換p幣	link_title
捏他	bracket
捅李星	bracket
捅了一個大將軍，還有千千萬萬個子弟兵	bracket
挑戰	bracket
拿聖靈寶劍斷開魂結，斷開鎖鏈！斷開一切的牽連！	bracket
拿破崙:滑鐵盧之戰只怪我買了自由而不是聯合報	bracket
拜託不要，我對兔子過敏...囧	bracket
拜託不要，我對XX過敏	link_title
招喚L2M	bracket
拚命秀下限	bracket
拚命	bracket
拖稿	link_title
拔草測風向	bracket
拓也哥	link_title
拎杯	bracket
拍照存證	bracket
拉維奇你這個小壞壞 XD	bracket
拉板凳	bracket
抽角爆死非洲人	bracket
抽牌吧	bold
抹茶糰子	bold
抹布	link_title
抱緊處理	bold
抬蚵	bracket
抨擊Popovich沒能力、該下台	bold
抨擊Manu球迷"只會護航"、"不懂球"、"馬迷"	bold
投票系統	link_title
抓錯字魔人	bracket
抓到了，錢沒用完，請退選	bracket
抓到了，柯P又失言，請退選	bracket
抓到了！ＸＸＸ是婉君	bracket
抓到了！ＸＸＸ也沒穿褲子	bracket
抓到了！Siri也是鄉民	bracket
抓到了！	link_title
抓到了CNN 是綠的柯P請退選	bracket
抓到了	link_title
把肉捧給她吃	bracket
找棵樹上吊自殺吧	bracket
找出美女帥哥照片	bracket
批踢踢實業坊	bold
批踢踢	bracket
批評	bracket
批波酸馬	bold
批判	bracket
批兔	link_title
打鐵王	bracket
打臉文	link_title
打臉、打臉文、臉都腫了	link_title
打臉	link_title
打砲	bracket
打球	title
打掉重練	bold
打工板	link_title
打字王是我們的王	bracket
打字王	link_title
打嘴炮	bold
打喵王	bold
打喵爵士	bold
打出全壘打	bracket
打T高手。	bold
打T高手	title
才不告訴逆呢	bracket
才200 難怪會落選"	bold
手滑了	link_title
手機版	link_title
手機 app	link_title
手動置底	bracket
扁維拉又救援成功了	bracket
扁維拉上來救援了	bracket
扁維拉	link_title
所需的分類	link_title
所以我說醬汁呢	link_title
所以什麼是越位？	bracket
戴爾標錯價事件	link_title
戰鬥民族首領	bracket
戰鬥民族的XX	bracket
戰鬥民族	link_title
戰鬥女子學園	link_title
戰類組	bold
戰隊集合	bracket
戰藍綠	link_title
戰職業	link_title
戰略高手	link_title
戰略模擬遊戲板	link_title
戰男女	link_title
戰替代役	bold
戰文青	bold
戰文起手式	bold
戰文組	link_title
戰文	link_title
戰意滿點	bracket
戰役別	link_title
戰學校	link_title
戰女文	link_title
戰女	link_title
戰大學	link_title
戰地方	link_title
戰國策	bracket
戰史板	link_title
戰南北	link_title
戰北車	bracket
戰公務員	link_title
戰一下	bracket
戒 PTT	link_title
我難過的是	bracket
我難過	link_title
我雞排已經買好了	bracket
我開始相信你了	bracket
我都唸ikea、我都唸costco	title
我那隻很會打棒球ㄉ機機跟我說ㄉ，對了，有誰可以寄動畫給我看嗎？F7	bracket
我那天不在 別在一直找我	bracket
我選完還有別的帳號繼續選	bracket
我道歉是因為向大家表明我願意改過、我希望能夠作得更	bold
我遇到誰誰誰了	bracket
我這周五請假一天	bracket
我這個人很簡單，有XX就推	bold
我這人很單純，有XX就推	bold
我跟郭台銘平均資產一千多億，所以我很有錢嗎	bracket
我跟李小龍哪根本就是師兄弟，難道我到處去告訴別人嗎？成龍他們哪整天過來跟我一塊喝茶，我很少應酬他們呀！這就是成龍，你也看到了，難道這些我也要告訴你嗎	bracket
我認為至少到季後再說，畢竟最近時刻比較敏感，馬刺板可能會被放	bold
我認為啊，空手道是世界上最強的武術了，所以精英中心應該只有空手道部，其他都應該廢除	bracket
我覺得安麗是世界上最強的直銷，其他的應該廢除	bracket
我覺得不行	link_title
我要幹死ttb	bracket
我要寫個慘字	link_title
我裡面沒穿唷～不准偷看我穿衣服	bracket
我被吳鳳	bracket
我聚賭最多就罰三千	bracket
我老爸不只變成了兔子，還跟你老媽結婚生子，所以才生下你這個獨眼龍的兒子	bracket
我老婆、老婆	bold
我老婆	link_title
我的阿曼尼啊！	bracket
我的觀察啦	bracket
我的褲子怎麼不見了	bracket
我的眼睛業障重	bold
我的盾牌怎麼不見了	bracket
我的槌子不不見了怎麼辦	bracket
我的最愛	link_title
我的2沒壞	bracket
我王境澤就算餓死，死外邊，從這跳下去，不會吃你們一點東西	bracket
我沒使用鏡花水月	bracket
我本身我奉公守法 如果今天我不對 我賠不是	bracket
我朋友…	bracket
我有一個程式可以繞過解密程序直接提取檔案，超方便	bracket
我是鄉民我要雞排	bracket
我是跟鄉民進來看熱鬧的，只是往前站了一點	bracket
我是男的	bracket
我是好友、我們互粉互讚不互噓	bracket
我是台灣人	bracket
我是來XXX der	bracket
我是不是走錯板	bracket
我早就發現常溫超導了只差沒發表 結果都沒廠商來談合作，我的發明比他這個小型核反應爐 汙染更低	bracket
我愛黎明！我愛黎明	bracket
我愛黎明	bracket
我愛XXX	bracket
我想跟虎哥一樣	bracket
我想跟你xx。	bold
我快死了	bracket
我很想知道她（蔡英文）的台灣價值是什麼。	bracket
我幫我朋友問…	bracket
我布這個局布了一年之久	bracket
我就是很想噓所以噓了	bracket
我就是人稱三重劉德華，男人中的極品	bracket
我寫了一個資料庫轉換程式任何語系都可無痛轉換 原PO要嗎?	bracket
我家閃光	bracket
我家的床又大又舒服	bracket
我家的小孩很乖，一定是…帶壞他的	link_title
我家巷口屌打	bold
我宣布XX屆廢文大賽正式開始	bracket
我媽問我為什麼（跪著看電腦）	bracket
我媽問我為什麼	bracket
我媽	bracket
我夢到…就醒	link_title
我夢到…	bracket
我夢到...就醒了	link_title
我夢到	bracket
我在蘆洲火車站的火字下等你	bracket
我在火字下等你	bold
我在法國看過一幅畫	bracket
我在最近五百副牌裡加進去的	bracket
我在大都等你	bracket
我在哪?	bold
我在上海十年的日子	bracket
我因為這些《戰女》文而去下載，是不是算輸了？	bracket
我和巴拿馬總統也有點交情	bracket
我同學…	bracket
我可以	link_title
我只剩下幾天可以活	bracket
我又再跑回去看	bracket
我到底看了三小紀念日	bracket
我判定fuxkyou賄選，即刻喪失參選資格	bracket
我先	bracket
我做生意 我坦蕩蕩	bracket
我借了海棠小姐的一根頭髮	bracket
我們繼續關心台灣的邦交	bold
我們繼續關心	title
我們懷念他	link_title
我們只訓練精英，絕不會接受垃圾	bracket
我們受夠被噓惹!我們想自救被推!	bracket
我們也是受害者	link_title
我個人覺得他不做作笑的又自然散發一股特別的氣質	link_title
我個人覺得他不做作 笑的又自然 散發一股特別的氣質 、莎拉之亂	link_title
我個人覺得	link_title
我佛你	bracket
我佛	bracket
我以前和你一樣也是個冒險家，直到我的膝蓋中了一箭。	bracket
我今天才知道	bracket
我也是今天才知道…	bracket
我也想上車	bracket
我不行	bracket
我不希望阿麗跟一個垃圾在一起	bracket
我lag了嗎？	bracket
我220公分，我要幹你，你是我的小隻馬	bracket
成龍表示：.....	bracket
成龍	link_title
成就感	bracket
成大狗鼻哥	bold
成名曲	bracket
成吉思汗健身俱樂部進化綜合格鬥中心	bracket
成功大學ip	title
成全你	bracket
懷孕事件	link_title
懶覺女人	link_title
懶懶王	bracket
懶叫王	bold
懶叫文	bracket
懶叫好吃^Q^	bracket
懶人包	bold
應該來隻綠皮卡	bracket
應該	bracket
應啦幹	bracket
懂就懂，看不懂就算了	bracket
慶記外送	bracket
慶記	link_title
慟！	bracket
慟屁喔	bracket
慟三小	bracket
慘了以後賭神要去當按摩的了	bracket
感謝小雞	bracket
感謝大大無私分享、樓主好人一生平安	title
感謝大大無私分享	bold
感謝大大	bracket
感謝yoyo大	bracket
感情生變跟逢場作戲	bracket
感動	bracket
感冒系歌手	bold
愛酸人的鄉民	bracket
愛莉	bracket
愛老虎油	bracket
愛洨會	bold
愛撫妻露點	bracket
愛吃烤香菇嗎	bracket
愚人節快樂^^	bracket
意淫文字	bracket
意淫推文之亂	link_title
意外死	bracket
意圖使人蹺課	bracket
意圖使人決鬥	bracket
意圖使人推爪爪	bracket
意圖使人推意圖使人XXX	bracket
意圖使人想歪	bracket
意圖使人吃宵夜	bracket
意圖使人不睡覺	bracket
意圖使人不當選	bracket
意圖使人xxx	bold
愉快	bracket
惹毛	bold
想釣？	link_title
想什麼文	link_title
想不想做愛？	bracket
惱羞	link_title
惡人先告狀	bracket
惠惠之亂	link_title
惠惠	link_title
情花開，開燦爛	bracket
悲！驚！悚！怒！急！恐！	bold
您是地質系的嗎	bracket
恨意	bracket
恐怖連結	link_title
怪異	bracket
性向自婊	bold
怡君vs雅婷	link_title
怡君VS雅婷	bold
怡君	bracket
怕太太	bracket
怕.jpg	link_title
怒砍n分	bracket
怒砍2分	bracket
怒砍	bracket
怒睡一波	bracket
怒看一發	bracket
怒發一篇	bracket
怒推一發	bracket
怒打一發	bracket
怒打一槍	bracket
怒尻一槍	bracket
怒噓一波	bracket
怒噓一樓	bracket
怒吃一O	bracket
怒XnO	bold
怒X	bracket
怎麼連qn也黑了	bracket
怎麼沒有綠皮卡	bracket
怎麼會是雲朵（雷公），再給你一次機會	bracket
怎麼是洋蔥文	bracket
怎麼又是你	bracket
怎麼剛才沒有現在有	bracket
怎樣啦，中華大學又怎樣啦，不爽踹共啦	bracket
快跟	bracket
快樂	bracket
快推，免得別人以為我們看不懂	bold
忠孝	link_title
忍者亂太郎板	link_title
必須死	bracket
忄重力	bracket
忄動	bracket
心機肥婆	bold
心愛騎士	bracket
心情小品集	bracket
心得文、你個板？	link_title
心得文	link_title
心ぴょんぴょん待ち？	bracket
微雷	bracket
復辟	bracket
復活了	bracket
復權	link_title
御宅族	bracket
從開學前幾個月就一直唸書，唸到面試十幾次拿到好幾個offer 一年半來唯一參加過的party是台灣同學會的新生welcome party	bracket
從未互粉互讚過的好友 - GGrunrundela	bold
從我知道馬丁費里曼的歧視言論之後，就不上電影院他參演的戲了，所以這次黑豹passy	bracket
得罪了鄉民還想逃	link_title
得罪了方丈還想走	bracket
得罪了XX還想逃	bold
得啦幹	bold
徐展元板	link_title
徐展元	link_title
後附	bracket
後 50 筆	link_title
律師函	bracket
很魯	bracket
很難笑	bracket
很閃	link_title
很重要所以要講三次	title
很肥的宅男	bracket
很累	bracket
很神的人	bracket
很神	bracket
很操	bracket
很恐怖	bracket
很好用	bracket
很多人以為我是先看在猜，其實我是未看先猜	bracket
很多人	bracket
很兇	link_title
很不方便	bracket
待撰寫條目	link_title
影響力	bracket
影片太好笑了啦	bold
影片	bracket
彰化田中將大	bracket
彩虹小馬	bracket
彩色猴子	link_title
彥州之亂	link_title
彥伯尋臍	bold
彥伯問臍	bold
彗星炒飯	bracket
彐厶	bracket
彎刀	bracket
彈蛋椅	bold
彈出來了	title
彈出來	bold
強者我朋友如何如何	bracket
強者我朋友	bracket
強者我同學	link_title
強者	bracket
強暴了	link_title
強暴	bracket
強國	link_title
強中自有強中手，一山還有一山高。何金銀這次戰術運用成功，你應該心服口服才是，現在你打贏了還要趕盡殺絕，太過分了	bracket
張貼	link_title
張爸文	link_title
張爸	link_title
張媽控訴台大長期欺負人	bracket
張媽	bracket
引戰文	link_title
引戰之亂與母豬教進攻女板之亂‎	link_title
引戰之亂與母豬教進攻女板之亂	link_title
引戰之亂	link_title
引戰	link_title
弒父姦母	bracket
建議千萬別這樣做…上次有人這樣…結果…就少一個…很不方便	bold
建景事件	link_title
廣告回來後，我們再繼續關心 XX 。	bracket
廢話	bracket
廢死	link_title
廢文系	link_title
廢文王	link_title
廢文局	link_title
廢文大賽、西斯廢文夜	title
廢文大賽	link_title
廢文	link_title
廢到笑	bracket
廠廠	bracket
廖大	link_title
康熙來了板	link_title
幻想有妹妹的文章	link_title
幻想文、醒醒吧你根本沒有…	link_title
幻想文	link_title
幻想妹妹文	link_title
幻想	link_title
幹，拎杯骨科（啦）！	bracket
幹，拎杯骨科啦	bracket
幹！地震！	bracket
幹政治板	bracket
幹嘛洗板啊	bracket
幹古哥	link_title
幹你媽的，炸死你全家	bracket
幹0糧雞掰	bracket
幹0糧母豬滾喇幹	bracket
幹0糧母豬滾喇ob'_'ov	bracket
幹 拎杯就是不敢吞自己懶趴拉 怎樣	bracket
幸福城市你敢嘴	bracket
幸福城市	link_title
年過35，仍是一個孤單未婚之人，於stock板	bold
年輕人終究是年輕人	bracket
年輕人畢竟是年輕人	bracket
年俸泥棒	bracket
平衡打擊	link_title
平安喜樂	bracket
平反	bold
平偉	link_title
干我屁事	bracket
幫高調	bracket
幫騙	bracket
幫補血	bracket
幫蓋	bracket
幫病魔集氣	bold
幫噓	bracket
幫優文	bracket
幫QQ	title
常駐看板人氣	link_title
常駐人氣	link_title
常識啊	bracket
常站在與政府對立的立場	bold
帶風向	link_title
帳號部	link_title
帳號砍除之亂	link_title
帳號服務站長	link_title
帳號	link_title
師生和議超過16歲到底為啥不能吃？	bracket
帥哥美女板	bold
帝吧大軍根據地	bold
帝吧出徒、寸草不生	bracket
帝吧出征 笑到往生	bracket
帝吧	bracket
希洽活躍板友	link_title
希洽板(C Chat)	title
希洽板	link_title
希洽	link_title
布袋戲版	link_title
布袋戲板	link_title
布丁之亂	link_title
市民廣場	link_title
巴西圓仔	link_title
巴西之亂	link_title
巴士板（bus）	link_title
巴嘎迥	bold
巴嘎囧、八嘎囧	title
巴嘎囧	bracket
巴哈百科中的我婆條目	link_title
巴哈姆特	link_title
巴偉	bold
已跪	bracket
已被hateOnas刪除	bracket
已被blaz刪除	bracket
已被XX刪除	title
已被XXX刪除	bracket
已經練到快可以碰到了，大家別急	bracket
已經吃飽了	bracket
已經到公海了!	bracket
已知用火	link_title
已抱緊	bold
已報警	link_title
差點	bold
巫術的權勢	bracket
巨人	bracket
左邊是鎧之巨人，右邊是超大型巨人	bold
左邊是鎧之巨人（即萊納，下圖黃髮），右邊是超大型巨人（即貝爾托特，下圖黑髮）	bracket
左邊是超大型廢文，右邊是鎧之廢文	bracket
左邊是超大型巨人，右邊是鎧之巨人	bold
左邊是超大型XX，右邊是鎧之XX	bracket
左邊是XX巨人、右邊是XX巨人	bracket
左邊是XXX、右邊是XXX	bracket
左轉jay板	bracket
左轉Marginalman板	bracket
左轉	bracket
左膠	bracket
左盃	bold
左手右手	bracket
左手	link_title
左岸沉思	bold
左右心口不一推文	bold
工讀生	link_title
工口芒果老師	bracket
工友	bracket
川寶	bracket
崩潰組	bracket
崩潰	link_title
山羊魔咒	bracket
展現出恨意的點	bracket
屍體	link_title
屁股榨甘蔗汁	link_title
屁股推	bracket
屁孩用語	link_title
屁孩	link_title
尻槍	link_title
就是很悲劇很悲催很淒慘很讓人心疼的回收....那還是回收阿!!	bracket
就射了、射出來了	link_title
就可版	link_title
就可板	link_title
就可	link_title
就像太陽餅裡沒有太陽一樣	bracket
尚書大人還真機靈 風往哪吹 你就往哪倒 真是佩服	bracket
尚書大人	bracket
少時不讀書，長大當記者	bold
少女時代板	link_title
小龜	bracket
小魚的紫色花園	link_title
小馬	bracket
小雲蟲	bold
小雪之亂	link_title
小雪	bracket
小雞	bold
小隻馬幹起來很棒	bracket
小隻馬	link_title
小隻	bracket
小英	bracket
小美家爆炸	link_title
小綠	bracket
小組長	link_title
小組	link_title
小精靈	link_title
小秘密	link_title
小祕密	link_title
小百合	bold
小當家之亂	link_title
小當家	bracket
小男生	bracket
小生	link_title
小狐	link_title
小熊明年拿冠軍	bracket
小熊今年拿冠軍	bracket
小愛	bold
小心駛得萬年船	bracket
小心被吉	bracket
小康妮轉陰蒂	bold
小小魯 快起床賺三百喔	bracket
小孩	bracket
小妹文	link_title
小妹哥	link_title
小妹	bracket
小女子	bracket
小天使	link_title
小圈圈推文	link_title
小商人	bold
小偷	bracket
小倫	bracket
小予予	bracket
小wei	bold
導盲犬	bracket
對面的女房客把自己鎖在外面	bracket
對面是跟臺灣不同的另一國，他們國內的事干臺灣屁事	bracket
對網路上的人出櫃	bracket
對立	bracket
對於挑釁之中華人民共和國人民 一律以最嚴格標準管理	bracket
對對對	bracket
對不起	bracket
尊爵、不凡、榮耀、台科大	bracket
專輯	bracket
專業文	link_title
專業打臉文	bracket
專業五樓	bracket
專業	link_title
將手上的錢全押了	bracket
射後不理	bracket
射出來了	bracket
射了	bracket
封禁	link_title
寶寶開心	bracket
寶寶文	link_title
寶寶心裡苦，但寶寶不說	bracket
寶寶心裡苦 但寶寶應該要說	bracket
寶寶好怕	bracket
寶寶之亂	link_title
寶寶	link_title
寶劍	bracket
寵物	link_title
寫文章	link_title
寫作紳士，唸作變態	bracket
寫作業	link_title
寫作xx、唸作XX	bracket
審查	bracket
寧沒吃早餐也要買聯合報	bracket
實體化	bracket
實況文事件	link_title
實況文	bracket
實況	link_title
富奸化	link_title
富奸、富奸化	title
富奸	link_title
富堡王	bracket
寄了 回我	title
家族	link_title
家人	bracket
宵夜文	link_title
室友	bracket
客家人	bold
定調	bracket
宗教文、體育討論文，學校文，地區文、西斯文、注音文、一行文、求檔文、PO出ID濫用公告	bracket
完蛋了	bracket
完全沒有畫面	bracket
完全沒有XX	bold
安麗	bracket
安溥	bold
安心XX，XXX不查IP	bracket
守護海岸線	bracket
守街亭	link_title
守住街亭	link_title
宅男	bracket
宅宅相輕	bold
宅宅	bracket
學長，請容我…	bracket
學歷都是假的，明明就是真理大學畢業	bracket
學校代碼	bold
學校ip	link_title
學校IP（學校代碼）	title
學校IP	link_title
學校 IP	bold
孩子的學習不能等	link_title
孩子的學習	bracket
季前反指標預測文	bracket
存股台積電，不如存股宏達電。	bold
孔明淚斬馬超	bracket
子彈	bracket
媽，我在這！	bracket
媽，我在這裡	bracket
媽！我在這！、媽！我上電視了！	title
媽！我在這裡！	bold
媽！我在這裡	bracket
媽！我在這	bracket
媽！我上電視了	bracket
媽我在這	bold
媽我上電視了	bracket
媽媽	bracket
媽奶文	link_title
婚姻板	link_title
婊子與狗，天長地久	bracket
婉君	link_title
娛樂與休閒	bracket
娘子～塊根牛魔王出來看上帝！	bracket
娘子，跟牛魔王出來看上帝	bracket
娘子，快跟牛魔王出來看神龍	link_title
娘子快跟牛魔王出來看神龍	bracket
娘子快跟牛魔王出來看上帝	bold
娘娘	bold
姦情	bracket
姐姐	bracket
姍姍來遲	bracket
始作俑者	bracket
姊寶	bracket
姆斯	bracket
姆咪騎士團參上	bracket
姆咪騎士團	bracket
姆咪教	bracket
姆咪心動動	bracket
姆咪74團參上	bracket
姆咪 媽的智障	bracket
姆咪	bracket
妹控王	bracket
妹妹被欺負惹怎摸辦？	bracket
妹妹文	link_title
妹妹廢文	bracket
妹圖文#沒圖	link_title
妹圖文#反串版本	link_title
妹圖文	link_title
妳.我都曾直接或間接推了一把	bracket
妮妮	bold
妓者不意外	bracket
妓者	link_title
如題	bracket
如果這不叫關說，那什麼才叫關說	bracket
如果球迷看不慣的話，可以不要到球場來看球	bracket
如果王建民明天先發七局無失分 我請前一百推吃曠世奇派 自取	bracket
如果歐陽妮妮多一條腿]	bold
如果有板友希望換板主或者有人毛遂自薦想要當板主的，基本上	bold
如果把台大20個學生抓到荒島,50年後…	bracket
如果德國贏了 我就吞十條女性丁字褲	bracket
如果妹妹XXX怎麼辦？	bracket
如果同花再加上順子，打不打得過啊	bracket
如果兩個水火不融的人都是好友呢	bracket
如本文標題所示	bracket
如何一句話惹惱ＯＯ	link_title
如何一句話惹惱	bold
好，還請大家能夠給我機會。	bold
好雷	bracket
好險我已經畢業了	bracket
好讀版	link_title
好讀板	bracket
好色龍	link_title
好胸	bracket
好笑	bracket
好文	link_title
好想X她	bracket
好恐怖	bracket
好帥	bracket
好噗好	bracket
好友陣線	bold
好友覺醒	bracket
好凶	bold
好兇，不摸嗎	bracket
好兇（脾氣不好、匈奴）	title
好兇	bold
好兄弟	bracket
好人逆襲事件	link_title
好人的逆襲事件	link_title
好人卡撲克牌	link_title
好人卡事件	link_title
好人	link_title
好了，下去領五百塊	bracket
好了！下去領五百塊	bracket
好了啦	title
好了	bracket
她，我可以	bracket
她，我不行	bracket
她我不行	bracket
她吳鳳我	bracket
奸商	bold
奶特板	bracket
女駕駛不意外	bracket
女神	bracket
女生說她要的很簡單，到底是要什麼？	bracket
女生擇偶的標準？	bracket
女生應該要欣賞省錢的男人	bracket
女生	bracket
女森	bracket
女板（WomenTalk）	title
女板板風	bracket
女板板主在女板約炮	link_title
女板主	bracket
女板	link_title
女性性版	link_title
女性	bracket
女孩版	link_title
女孩板	bold
女債主	bracket
女主播戀富少　楊伊湄：有錢人不會選我	bracket
奮起湖沒有湖	bracket
奧運板	link_title
奎頭	bracket
奈米屌	bracket
奈米哥	bold
失言	bold
失敗	bold
央大	bracket
太陽餅裡面沒有太陽	bold
太陽餅裡面沒太陽	link_title
太陽餅裡還不是沒太陽	bracket
太陽餅裡沒太陽	bold
太陽花學運	link_title
太閃了	bracket
太神啦	bracket
太恐怖了！那我寧可選擇醜女人，不要懶覺女人	bracket
太太我喜歡妳	link_title
太可怕了，先去吃某某食品壓壓驚	bracket
太可怕了，先xxx壓壓驚	bold
太可怕了（恐怖、嚇死人了），先xxx壓壓驚	title
太可怕了	bracket
太不八卦	bracket
天龍國不意外	bracket
天龍國、天龍人	bold
天龍國	bracket
天龍人	link_title
天龍	link_title
天蓬國	bracket
天花板也沒有洞啊	bracket
天終於可憐我了	bracket
天空爵	bold
天空熊	link_title
天王	link_title
天擇	bold
天才小釣手	bracket
天天看聯合報，社會滿分	bracket
天大地大台科大，爹親娘親逢甲親	bracket
天大地大台科大、118、台科文	title
天大地大台科大	link_title
天啊！這你敢相信嗎？	bracket
天啊	bracket
天哥好人卡事件	link_title
天哥	link_title
天使節	link_title
天使之亂	link_title
大魯閣打擊場	bracket
大魔王	bracket
大食客	bracket
大隻	bracket
大陸不意外	bracket
大陸	bracket
大都卡	bracket
大都	bracket
大規模毀滅性武器	bold
大葉	link_title
大航海時代	bracket
大腿推	bracket
大聲	bracket
大綠	link_title
大笑	bracket
大神	bracket
大眾情人	bracket
大烘窯	bracket
大氣科學版	link_title
大氣科學板	link_title
大檢視，新板主季後再上任會比較自在些	bold
大樓	bold
大概是這樣	bracket
大概又要四海遊龍了	bracket
大杯鑽	bracket
大木之亂	link_title
大怒灌	bold
大心	bold
大平台	link_title
大師兄黎明	link_title
大師兄嬌喘一聲倒在何金銀的懷裡，這個時候大師兄眼如媚絲溫潤的雙唇微微張開， 還噴出有如蘭花一般的香氣…	bracket
大將軍的請託	bracket
大將軍	link_title
大富翁	link_title
大家都針對我	bracket
大家都看不起她	bracket
大家都有責任	bracket
大家都噓（推）我只好推（噓）了	link_title
大安國	bracket
大學生網路乞討事件	link_title
大學	link_title
大大、X大	title
大大	bold
大哥大姊	bracket
大同電鍋	link_title
大勢已去	bracket
大Q	bold
夜賺三百	bracket
夜生活版	link_title
夜生活板	link_title
多重帳號查詢	link_title
多重帳號	link_title
多蛙、空蛙	link_title
多虧妳向恩	bracket
多篇無意義推文	link_title
多次與特定版友爭執，也質疑版主spurs2120的執法標準，多次衝撞制度，試圖打破spurs2120等人所寡頭領導的刺版菁英老大哥主義，尋求標準一致，懲戒特定版友的人身攻擊與嘲諷羞辱版風，最後更進而要求版主改選	bold
外送美式民主	link_title
外送民主	title
外省豬	bracket
外省第二代	bracket
外勞殺手	bracket
外來種	bracket
士口	bracket
壞掉了，50收	bracket
壞掉了50收	bold
壞掉了	bracket
壞了，一百收	bracket
壞了XX收	bracket
壞了50收	bracket
壞了	bracket
壓壓驚	bracket
壓力測試	link_title
墨鏡	link_title
墨西哥王	bold
墨吸哥	bracket
塊陶阿	bracket
塊陶啊	bracket
塊陶	bracket
塊根	bracket
場外	link_title
報警處理	bold
報案	link_title
報數	bracket
報名	bracket
報到	bracket
基金版	link_title
基金板	link_title
基督板亂事	link_title
基本用語	link_title
垃圾再多還是垃圾阿，你有看過trash/garbage加s的逆	bracket
垃圾不分藍綠	bracket
垃圾	bracket
地震是因為久旱土質鬆軟，突然下雨所造成	bracket
地震文	link_title
地震	link_title
地質系	bracket
地表最強生物	bracket
地理老師常請假	bracket
地理板	link_title
地獄式死亡特訓正式開始	bracket
地方的媽媽（們）需要…	bracket
地方的媽媽需要老二	title
地方的媽媽需要第二胎	bold
地方的媽媽需要檢舉	bracket
地方的媽媽需要 zoeforce	bracket
地方的媽媽…	bracket
地圖炮	bracket
在電腦前下跪	bracket
在銀幕前下跪	bracket
在螢幕之前下跪	link_title
在樓梯間哭	bracket
在我床上	link_title
在座的各位全都是垃圾	bracket
在對方的傷口上灑鹽	bracket
在你背後，他非常火	bold
在你後面，他現在很火	bold
在一起～在一起～ 在一起	bold
在一起、在一起	link_title
在一次	bracket
在一年	bracket
土豪之亂	link_title
土城救援王	bracket
團結的故事	link_title
團地妻需要老二	bracket
團地妻	bracket
圖謀天王之位	link_title
圖王	link_title
圖片有聲音	bracket
圖庫王	bold
圖后	bracket
圖勒	bracket
圓維拉	bracket
圓仔洗白了	bracket
圓仔文	link_title
圓仔在ptt的迴響	link_title
圓仔在ptt、支那賤畜	link_title
圓仔	link_title
國際盜懶叫集團	link_title
國防布	bold
國軍不意外	bracket
國軍	link_title
國考板	link_title
國立私立比不過兩粒	bracket
國立嘉義大學	bold
國王的標題	title
國王的新衣	bold
國民黨完了，民進黨別笑	bracket
國民黨	link_title
國民岳父	bold
國民乾爹	bold
國文老師常請假	bracket
國慶等事件	link_title
國慶爺	bold
國慶煙火	bracket
國慶之亂	link_title
國家體育場	link_title
國家認證的邊緣人	bracket
國家研究院	link_title
國光幫板	link_title
困哈星	bracket
団地妻	bracket
因該	bracket
因為陸客不來了....	bracket
因為陸客不來了	bracket
因為西索小時候家裡很窮	link_title
因為你這個皮帶龜裂.....普利珠啦	bracket
因為你散發出臭味	bracket
因為你太臭了	bracket
因為 Lavchi 上任的時間很短，又有人稱他為「最短的板主」。	bold
因此讓性板看到黃色笑話、在笑話板裡面看到帶恨意的黑色幽默、又會在恨板因為別人的糗事而發笑	bracket
因不小心收服了一隻喇叭芽、還讓它進化成口呆花，又「不小心點到存檔」的選項	bold
回覆	link_title
回文	link_title
回娘家	link_title
四郎閉嘴	bracket
四行倉庫	bracket
四海遊龍、吃鍋貼	title
四海遊龍	bold
四插貓	bold
四寶	bracket
四天王	link_title
四叉貓	link_title
四叉屎	bold
四叉喵喵	bold
四X貓	link_title
嚇死我了，先抽根煙壓壓驚吧	bracket
嚇死寶寶了	bracket
嚇死人了	bracket
嚇人	bracket
噓爆	bracket
噓文（噓爆）	title
噓文救爵士	bracket
噓文救水兵	bracket
噓文救書豪	bracket
噓文救我豪	bracket
噓文救XX板	bracket
噓文救XX	bracket
噓文救AHQ	bracket
噓文救 XX	bracket
噓文	link_title
噓北車	bracket
噁之亂	link_title
嘻嘻	bracket
嘻哈	link_title
嘴角失守	link_title
嘴砲	bracket
嘴炮	bracket
嘴巴說不要，但身體還挺誠實的	link_title
嘴巴	bracket
嘔嘔嘔嘔嘔	link_title
嘎偉老師	bold
嘉義板	link_title
嘉義小商人	bold
嘉義大學	link_title
嘉義人	link_title
嘉大	link_title
嘉偉老師	title
嗯嗯！跟我想的一樣	bracket
嗜插貓、一星貓、八千貓	bold
嗚 我是乳蛇	bracket
嗑頭自殺	bracket
嗆我嗆夠沒	bold
嗆我嗆夠了沒有	link_title
嗆我嗆夠了沒	bracket
嗆我嗆夠了嗎？	bracket
嗆夠了沒	bold
單親家庭板	link_title
單眼相機板	link_title
單挑	link_title
喝喝逆	bracket
喝喝	bracket
喜歡你溫暖的文字 洋溢著滿滿的幸福：）	bold
喜歡你溫暖的文字 洋溢著滿滿的幸福：)	link_title
喔～氣氣氣氣氣	link_title
喔~~喔喔~~喔喔~~喔喔~爪爪	bracket
善子推	bold
善子廚	bold
啤酒	bracket
啟動聖人模式	bracket
問號之亂	link_title
問板	link_title
問卷文	link_title
問卦	bracket
啊～嘶	bold
啊哈哈哈	bracket
商女不知亡國恨，一天到晚寫作業	bracket
唸法	bracket
唸大葉 好就業 將來可以成大業	bracket
唯讀	link_title
唯我獨尊	bracket
唯一支持中鋼J	bracket
唐鳳說什麼	link_title
唐伯虎點秋香	link_title
唉鳳八	bold
哭哭	bracket
哪部糞作，你直說辣	bracket
哪部	bracket
哪來那麼多屁話，長毛？？是你？？？	bracket
哩金變態	link_title
哈噗好	bracket
哈哈哈哈，你看看你	bracket
哈哈	bracket
哈利波特	bold
哇靠文	link_title
哇靠	bracket
哆啦王	bracket
哆啦A夢表示…	bracket
哆啦A夢板	link_title
哆啦A夢 wiki	link_title
哀配三	bracket
哀佩妹妹	bracket
咩修幹某	bracket
呼叫可魯	bracket
呵呵	bracket
味道都飄出來了，快刪掉好嗎	bracket
呱吉、	link_title
周星馳	link_title
周慧敏	bracket
告白	bracket
告利蛋	bracket
告他	bracket
呂布	bold
吹風機插頭一直不拔會不會怎樣	bracket
吹風機插頭	link_title
吳鳳接鬼	bracket
吳鳳接軌	bracket
吳鳳	bracket
吳本身有珠三角 長三角兩大經濟圈，根本不缺錢	bracket
吳敦義表示…	bracket
吳憶樺（巴西圓仔）在ptt與巴西之亂	link_title
吳國長三角君	bracket
吱吱	link_title
否嬸	bold
否姐	bold
否姊	bracket
否妹	bracket
吐槽板	link_title
吐槽	bracket
吐嘈板（Tutsau）	title
吐嘈板	bold
名片檔	link_title
名為變態的神父	bracket
名為變態的神木	bracket
名單	bracket
名人	link_title
同花打不打得過Full house，那除非你爸變成了兔子	bracket
同秒OP	bracket
同理心	bracket
同樣意見（感受）的人加我一個	bracket
同性戀	bracket
同學	bracket
同事	bracket
同一人噓三次以上每超噓一次水桶一週	bracket
吉米兄弟	bold
吉死他	bracket
吉哥	bracket
吉到底	bracket
吉利蛋	bracket
吉他	bracket
吉下去	bracket
合購版	link_title
合購板	link_title
合太醬料	bold
各板萬用	bracket
各位大大	bracket
吃鍋貼	bracket
吃滷肉飯，喝10塊麥香系列	bold
吃水餃的癖好	bracket
吃慶記	bracket
吃幾碗	link_title
吃光光，咔咔	bracket
吃便當	bracket
吃不下去	bracket
吃下去	bracket
右鍵	link_title
史蓋爵士	bold
史蓋	bold
史上第一次	bold
史上最悲催回收	bracket
史上最強祭品文	bracket
史上最強手機	bracket
台魯	bracket
台詞	link_title
台菜二世祖	bold
台肯	bracket
台股大怒神	bracket
台籃板	link_title
台積電	link_title
台科文	bold
台科學生證	link_title
台科大校歌	bracket
台科大	link_title
台獨吉娃娃	link_title
台獨剋星	bracket
台灣語言板	link_title
台灣科科大學	bracket
台灣科技大學	link_title
台灣皇民	bracket
台灣最大線上BBS上線啦	bracket
台灣價值不足	bracket
台灣價值	bracket
台灣人依然不能接受師生戀	bracket
台清嘉成	bracket
台清元交	bracket
台清交元	bracket
台成清嘉	bracket
台女不意外	bracket
台女EZ	bracket
台大欺壓張媽15年了	bracket
台大板	link_title
台大五姬	link_title
台大	link_title
台南市長榮女中	bracket
台南市長榮中學	bracket
台南市長怎麼一直換人？	bracket
台南市長就可以亂砍樹嗎？	bracket
台南市長到底是榮中學還是榮女中啊？	bracket
台南市長不是賴清德嗎？，怎麼會是 榮中學	bracket
台南市長 榮中學	link_title
台南市長  榮中學	bold
台北車站	bracket
台北市代燒其他縣市垃圾的議題	bracket
台北女生身材比較好?	bracket
台北地下街為什麼有區總是那麼臭？	bracket
台北國	bracket
台劇板（Taiwandrama）	title
台劇板	link_title
台元清交	bracket
台中版	link_title
台中板	link_title
台中李奧納多皮卡丘	bold
台中不意外	bracket
台中	link_title
可魯～救我！！我看不到了	bracket
可魯，快吠他	bracket
可疑的縱火	bracket
可是瑞凡，我回不去了。	bracket
可是瑞凡	title
可撥	link_title
可憐哪	link_title
可愛板（kawaii）、中國科技大學板（cute）	title
可愛板	bracket
可愛	bracket
可惡，想舔	bracket
可惡，想摸	bracket
可惡，想揉、可惡，想X	title
可惡，想揉	bold
可惡，想拆	bracket
可惡，想吸	bracket
可惡，想X	bracket
可惡，想	bracket
可惡想買	bracket
可惡想要	bracket
可惡想看	bracket
可惡想噓	bracket
可惡…	bracket
可惡	bracket
可以這樣閃了又閃、閃了又閃嗎？	bracket
可以幫我收個簡訊嗎	bracket
叮噹王	bracket
叭叭叭	bracket
召喚好色龍	link_title
召喚mayaman	bracket
只要是動漫迷都可被酸，不論你是哪種廚都來取暖吧	bracket
只要噓到X1以上就砍文章並水桶七天	bracket
只能跪了	bracket
只能說在12樓	bracket
只有56才能超過56	bracket
只是車欠骨豊	bracket
只是我的夢	bracket
只是可笑的發音	bracket
只投一票	bracket
只不過是一根中藥材	bracket
古龍板	link_title
古人八卦板	link_title
口碑場	bracket
口卡	bracket
口交臉	bracket
口交姨	bracket
口交 猜一成語	bracket
口交  猜一成語	bracket
取消發文獎勵	link_title
取暖	bracket
反黑箱服貿事件	link_title
反駁	link_title
反象大將軍	bold
反詐騙	title
反觀民進黨	bracket
反觀XXX	bold
反觀	bracket
反義注音標記	bold
反白	link_title
反甲連長	bracket
反甲連	link_title
反甲第一猛將	bold
反甲	link_title
反洗腦課綱	bracket
反波波事件	link_title
反服貿立法院攻佔事件	link_title
反服貿攻佔立法院與ptt	link_title
反服貿攻佔立法院事件	link_title
反服貿佔領立法院事件	link_title
反攻大陸	bracket
反指標，不意外	bracket
反指標	bold
反托拉斯法	bold
反壟斷	bold
反串王	bold
反串文	link_title
反串失敗，零分	bracket
反串	link_title
又黑了	bracket
又肥又宅	bracket
又是你	bracket
又掉下來兩顆	bracket
參上	bracket
去死去死去死	bracket
厲害了，我的X	bracket
厲害了，XXX	bracket
厲害了我的國	link_title
厲害	bracket
原始人	bold
原原po	bracket
原來機器人也會回文	bracket
原來是這樣	bracket
原來我的2沒壞	bracket
原來下去領500是真的？	bold
原來SOD都是真的	bold
原來SOD的劇情都是有所本，而不是憑空想出來的	bracket
原來MoNeNe說的是真的	bracket
原po被打臉	bracket
原po臉都腫了	bold
原po真是尚書大人	bracket
原po的臉好白哦	bracket
原po比較正	bracket
原po是正妹、原po比較正	title
原po是正妹	bracket
原po數學老師常請假	bracket
原po怎麼長得這麼像熊	bracket
原po怎麼長了三條手臂，好可怕	bracket
原po怎麼一下男生一下女生	bracket
原po你好糟糕	bracket
原po以為國外黑人是白人化妝成黑人的嗎？	bracket
原po中肯	bracket
原po	link_title
原PO別急，沒關係~她在我床上 我等等幫你告訴她。	bracket
原PO	link_title
原 PO	bracket
厚問文	bracket
厚問	bracket
即時熱門看板	link_title
印象	bracket
印尼行不行	bracket
印尼王	bold
印和闐	title
印何闐、印何闐	bracket
卡神	bracket
卡特蘭大	bold
卡漫綜合小組長分身亂板事件	link_title
卡漫夢工廠	link_title
卡提諾狂新聞	link_title
卡好大	bold
卡好	bold
卡大	bold
卡卡的	bracket
卡卡獸	link_title
南部不意外	bracket
南部	bracket
南貓北狗	bracket
南港板	link_title
南寧腔華語	link_title
南台灣	link_title
協尋文	link_title
半斤批霜	link_title
千萬不要去google兩女一杯	bracket
千杯千杯再千杯	title
千杯	bracket
十里坡劍神	bracket
十萬青年十萬肝 GG 輪班救台灣	bracket
十年	bracket
十二樓	bracket
十二惹	bracket
十二	bracket
匿稱	link_title
匿名板	link_title
匿名	link_title
北連中胡	link_title
北車	bracket
北越狐事件	link_title
北越狐	bold
北越妖狐	bold
北越	bracket
北科王	bold
北科大名校实属牛逼	bracket
北投車站	bracket
北台灣地區的台北高中都是有問題的一貫道教徒	bracket
北京車站	bracket
北七	bracket
匈奴人	bold
匈奴	bracket
包莖：一場思辨之旅	bracket
包莖文	bold
包子讚讚讚	bracket
勿急 勿慌 勿戰  正常能量釋放	bracket
勸世寶貝喵喵在PTT	link_title
勸世寶貝喵喵	bold
勸世圖	link_title
勸世	bracket
勞工板	link_title
勝文？是你？	bracket
勝文	bracket
勝利	bracket
動物是無辜的	bracket
動漫迷的地獄	bracket
動漫帝國	bracket
動圖王	bracket
勇者！	bracket
勇者	bracket
劣退	link_title
劣文退回	bold
劣文。	link_title
劣文	link_title
劣化	bracket
加進去的不是洨	bracket
加分文	bracket
加分	link_title
加了洋蔥	bracket
劉甜甜	bracket
劉氏	link_title
劉德華	bold
劇透	bracket
劇本文	link_title
剿滅肅清垃圾戰女/仙劍/發錢/廢推	bracket
創站	link_title
創意果實大賽	bracket
創世神	bracket
前面幾樓都是我的分身	bracket
前板主hateOnas仍有申訴繫屬於BoardCourt板，若日後前板主勝訴，判定恢復板主權限，則五位板主先讓於前板主回任，日後有板主出缺優先詢問是否願意回任	bracket
前幾樓少在那邊帶風向	bracket
前導概念片	link_title
剁老二	bracket
刻意為之	bracket
刺迷RJefferson	bold
到此一遊	bracket
到底要秀下限到什麼程度？	bracket
到天上去了	bracket
到南部弄假牙	title
别讓XX不開心	title
刪除文章	bracket
刪除	link_title
刪文。	link_title
刪文	link_title
利大於弊	bracket
別讓勝文不開心	bold
別讓佩琪不開心	bracket
別讓XX不開心	bold
別富奸啊	bracket
別再說踹共了	bracket
別再發月經文了	bracket
初音相關的梗	link_title
初音	link_title
初手天元	bold
切割	bold
分類帽	bracket
分類:關於鄉民百科	link_title
分類:主要關鍵字之亂	link_title
分類:PTT風雲人物投票	link_title
分類:PTT系統	link_title
分類:PTT看板	link_title
分類:PTT相關事物	link_title
分類:PTT流行語大賞	link_title
分類:PTT流行符號	link_title
分類:PTT流行用語	link_title
分類:PTT最新訊息	link_title
分類:PTT文體	link_title
分類:PTT文化	link_title
分類:PTT年度	link_title
分類:PTT基本用語	link_title
分類:PTT名人	link_title
分類:PTT列表	link_title
分類:PTT事件	link_title
分類:2020年關鍵字之亂	link_title
分類:2019年關鍵字之亂	link_title
分類:2018年關鍵字之亂	link_title
分類:2017年關鍵字之亂	link_title
分類:2016年關鍵字之亂	link_title
分類:2015年關鍵字之亂	link_title
分類:2014年關鍵字之亂	link_title
分類:2013年關鍵字之亂	link_title
分類:2012年關鍵字之亂	link_title
分類:2009年關鍵字之亂	link_title
分類:2006年事件	link_title
分類	link_title
分隔線	link_title
分辨之亂	link_title
分身帳號	link_title
分身公主	bracket
分身ID	link_title
分身	link_title
分派	bracket
分享	link_title
刃犬	bracket
刃太	bracket
出神入化	bracket
出生時候被抱錯	bracket
出征	link_title
出師表	link_title
出家人的智慧	bracket
出名	bracket
出去現在	link_title
出來面對	link_title
出來講	bracket
出來吧，卡卡獸	bracket
凶宅	bracket
凱文（kevin）之亂	link_title
凱文之亂	link_title
冷靜	bold
冷門看板	link_title
冷吱吱	bracket
冬季站服	link_title
冤冤相報何時了，往事知多少	bracket
冠軍	bracket
冒險蓋	bracket
冒牌貨	bracket
再推爆一次	bracket
再戰十年	bold
再啦幹	bracket
再去買東西壓壓驚	bracket
再一年	bracket
其實根本沒臺灣這個東西，她不是省，自廢了，她不是縣，更不是國，只是個鬼島	bracket
其實全PTT只有我一個人，不信我換個ID推一樣的話給你看	bracket
共用帳號禁止條例	link_title
公關站長	link_title
公開承諾又短期間毀諾	bracket
公道價八萬一	bracket
公道價81000收	bracket
公車板	link_title
公車時刻板（BusTimes）	link_title
公路板（Road）	link_title
公路三大殺手	bracket
公然侮辱	bracket
公海到了沒？	bold
公海到了沒	bracket
公海到了嗎？	bold
公海	bracket
公民覺醒	bracket
公民新聞	bracket
公告文	link_title
公告	link_title
公司	link_title
公共自行車板（PublicBike）	link_title
公共利益	bracket
公主病	link_title
公主V.S.教主	bracket
公主	bracket
八萬一	link_title
八方雲集	bracket
八希板	bold
八家將	bracket
八大之亂	link_title
八嘎迥	bold
八嘎囧	bold
八嘎	bracket
八卦（版）人氣…	bracket
八卦鄉民	link_title
八卦版人氣-1	title
八卦版不意外	bracket
八卦版	link_title
八卦清流	link_title
八卦歌詞網	bracket
八卦檢舉板	link_title
八卦板（Gossiping）	link_title
八卦板鄉民	link_title
八卦板發文上站次數限制投票	link_title
八卦板發推文限制修改投票	link_title
八卦板板主選舉	link_title
八卦板推文用語表	title
八卦板帥哥之夜	link_title
八卦板友名單	link_title
八卦板人氣-1	bold
八卦板主鬧劈腿事件	link_title
八卦板上站次數發推文限制修改投票、500之亂	link_title
八卦板2014年板聚	link_title
八卦板	link_title
八卦帥哥之夜	link_title
八卦女神	bracket
八卦十大謎團	link_title
八卦	link_title
八千貓事件(見爭議事件)	bold
八千貓事件	bold
兩女一杯	bracket
全世界最禿的垃圾	bracket
全PTT帳號都是我分身 不信我等等開分身上來說一樣的話	bracket
全PTT帳號都是我分身	link_title
全PTT只有我一個 其他都分身 不信我換帳號我同一句給你看	bracket
內有恐怖連結	bracket
內情並不單純	link_title
內地	link_title
入選	bracket
兜甲兒與他的快樂夥伴	bracket
兔子廚	bracket
兒童色情	bold
免費讀	bold
免疫	bracket
免洗ID	link_title
光榮板	link_title
先進入聖人模式	bracket
先補血	bracket
先拆座墊	bracket
先承認就是你自己	link_title
先承認你朋友就是你吧	bracket
先承認你就是本人吧	bracket
先承認你就是你朋友、先承認你同學就是你	title
先承認你就是你朋友	bracket
先承認你就是XXX	bracket
先承認你同學就是你	bracket
先承認	bracket
先別說這個了，你聽過安麗嗎？	bracket
先別管那個簡訊了，我有一個人生的志向，是我的事業，你聽過安麗嗎？	bracket
先別管這個了，你聽過安麗嗎？	bracket
先別管簡訊了，你聽過安麗嗎	bracket
先不管小便了，你覺得我的那傢伙怎麼樣？	bracket
先上車後補票	bracket
兄弟	bracket
兄台/姑娘 您好，我是小生，偶爾客串回文，點綴你的人生	bracket
元智魔人	bracket
元智大學	bold
元年	bracket
元台清交	bracket
儲存版	link_title
儲存	link_title
優文(優文數、優文制度)	bold
優文	title
億載金城武	bracket
傻花板	bold
傳麻繩	bracket
傳說中的十里坡劍神	bracket
傳說中的406出現了	bracket
備份文章、你只是想要備份吧！	title
備份文章	bold
備份	link_title
傑夫，你看到了嗎？	bracket
傅立葉	bracket
偽證	bracket
偽神父	bracket
偽物	link_title
偽死魚魚	bracket
偽娘	link_title
偽ID	bold
偷（偷拍、盜圖）	bracket
偷跑	bracket
偷渡	bracket
偷拍王	bracket
偷拍到他人女友一事	link_title
偷拍	bracket
偶像大師板	bold
偶像大師	link_title
健身板	link_title
停權	link_title
做夢文	link_title
做了蠢事	bracket
偏見	bracket
偏激	bracket
偏不噓	bold
偉大的瓦倫達家族	bracket
偉大板主	bold
偉哉愛撫妻	bracket
假神父	bracket
假的 我的眼睛業障重	link_title
假的	bracket
假文青	bracket
假妹	bracket
倫家4女森欸!	bold
借轉錄可愛板	bracket
借轉jay板	bold
借轉gay板	bracket
個人認為引戰，等其他板主意見	bracket
個人EP	bold
俺の嫁	bold
修文	link_title
信耶穌治皮膚病	bracket
信耶穌得鑽石 remix	bracket
信耶穌得鑽石	bracket
信義國	bracket
信箱	link_title
信徒	bold
信件	link_title
保齡球板	link_title
保證做愛的網站	bracket
保甲總隊	bracket
保安，保安	link_title
保安！可以讓人這樣X了又X X了又X嗎？	title
保安！可以讓人這樣X了又X X了又X	bold
保安！保安！可以讓人家這樣打了又打、打了又打、打了又打、打了又打的嗎！？這怎麼打啊！	bracket
保安	bracket
保佑XXXX	bracket
俊朗朗朗朗朗……	bracket
俊朗朗朗朗朗…	bracket
俊朗朗朗	bracket
俊朗	bracket
俊吉	bracket
係咪公海？	bracket
便當文事件	link_title
便當店老問不賣便當給菲勞，發文者幫他買便當	bracket
便當局（台鐵）	link_title
依法行政，謝謝指教	bracket
例外	bracket
來（去）看XXX秀下限	bracket
來測試一下吧，2沒壞	bracket
來大都找我吧、我在大都等你	title
來大都找我吧	bold
來大都找我	bracket
使用者名單	link_title
佳作	bracket
你那邊還來得及	link_title
你還是21小時之後再來吧	link_title
你還在用撥接嗎？	link_title
你這麼支持她（引起爭議的女性） 只是因為你是她的粉絲或是親衛隊、或只是想騙炮，像是騎士守護公主	bracket
你這輩子就這樣了	link_title
你這個局布了20年之久	bracket
你這個小壞壞	link_title
你逆	bracket
你誰啊，亂公告。	link_title
你誰啊，亂公告	link_title
你誰啊	bracket
你藏書系？	link_title
你萬一打輸了你的身材那麼好有沒有考慮過去拍三級片？我要拍也只會拍功夫片！	bracket
你腿了	bracket
你能怎麼樣，打我啊，笨蛋	bracket
你聽過安麗嗎？	bracket
你聽過Ang Lee嗎	bracket
你老爸在你後面他非常火	link_title
你突破盲腸了	bracket
你知道你媽在這裡PO廢文嗎?	bracket
你的孤單，誰來承擔？	bracket
你的406咧？	bracket
你當這裡是八仙樂園？	bracket
你爸媽平均有一顆睪丸	bracket
你為何要放棄治療？	bold
你沒有妹妹	link_title
你李嚴系？	bracket
你有freestyle嗎？	bracket
你有freestyle嗎	link_title
你最期待現役女優有機會拍無碼的	bracket
你是認真的嗎？	bracket
你是第xx個發現這件事的	title
你是第XXX個知道這件事的	bold
你是第XXX個看到這篇文章的	bracket
你是用電腦練蠱喔	bracket
你是有多愛藍染啊	bracket
你是擅長XX的朋友呢	link_title
你是我的豬肉片	bold
你是我的網羅 3.0	bracket
你是來秀簽名檔的吧	bracket
你是什麼時候產生了xx的錯覺	link_title
你是不把我奔雷手文泰來放在眼裡囉！	bracket
你文組的喔	link_title
你捐多少	link_title
你才黨員，你們全家都是黨員	bracket
你才文化人，你全家都是文化人	bracket
你才sorry，你全家都sorry！	bracket
你才XXX，你全家都XXX	title
你我都推了一把	bracket
你我都受害	bracket
你想篡位嗎？	bracket
你從什麼時候開始產生了我沒使用鏡花水月的錯覺？	bracket
你從什麼時候開始產生了我沒使用鏡花水月的錯覺	bracket
你很愛藍染喔！	bracket
你富奸了	bracket
你媽要是知道你現在這樣，一定非常傷心	bracket
你媽知道你在這裡發廢文嗎？	bracket
你媽知道你在這裡發廢文嗎?	bracket
你媽知道你在這裡po廢文嗎？	bold
你好糟糕，請暫時不要跟我說話	bold
你地質系？	bracket
你在大聲什麼啦、平偉相關梗	title
你在大聲什麼啦	bracket
你在大聲什麼	link_title
你嗆屁啊	bracket
你哪位	bracket
你咧大聲啥啦	bracket
你名義老爸在你後面，他非常火	bracket
你名義老爸	bracket
你可千萬別說你不是垃圾啊	bracket
你只是想要備份吧	bracket
你先承認你是xxx吧	bracket
你們快逃，我來擋	bracket
你個版？	bracket
你他媽的我到底看了三小	title
你什麼時有了XXXX的錯覺	bracket
你什麼時候產生了網王是運動漫畫的錯覺	bracket
你什麼時候產生了死神好看過的錯覺	bracket
你什麼時候產生了有女朋友的錯覺	link_title
你什麼時候產生了…	bracket
你什麼時候產生了XX的錯覺	title
你什麼時候產生了XXXX的錯覺	bracket
你什麼時候有了你有資格發藍染文的錯覺	bracket
你什麼時候有了XXX有良心的錯覺	bracket
你什麼時候有了XXXX的錯覺等	bold
你什麼時候…	bracket
你不用講啦 你有什麼不滿都沒關係 你去法院講 我都奉陪到底	bracket
你不是藍染王	bracket
你不乖就把你灌進消波塊喔	bracket
你po這篇文章一定會被噓爆的	bracket
你lag了	bracket
你XX系？	link_title
作業請自己寫	bracket
作業自己寫、作業文	title
作業自己寫	bold
作業自己做	bold
作業文	bold
作夢文	link_title
佛心公司	bold
佛你老木	bracket
何棄療	bold
何時可以宰	bracket
何不食肉糜？	bracket
低調碼	link_title
低調文	link_title
低調推（噓）	link_title
低調推	bracket
低調噓	link_title
低調、低調推、低調噓	title
低調	bracket
低能卡	bold
低學歷	bracket
位置資訊	link_title
位元堂、養陰丸，好似太陽般溫暖…太陽出來了	bracket
但spurs2120動輒以鎖文、刪文、浸水桶等版主權限，袒護某兩三位特定版友。	bold
伸相片	bracket
伸圖	bracket
休閒聊天區	link_title
伐伐伐伐伐伐伐伐木工	title
以毒攻毒	bracket
以學術性質為目的，提供各專業學生實習的平台	bracket
以下開放賭神台詞	bracket
以下開放決鬥	bracket
以下開放台詞推文	bracket
以上如果您完全都沒有遇到，那看來真的很棘手，還是先加我 line 然後我過去幫你處理好了	bracket
令良	bracket
令刀	bracket
代幣沒換好	bracket
代幣換很多	bracket
代工	bracket
仙樂園	bracket
仙劍體	bracket
仙劍版	link_title
仙劍板	link_title
仙劍哥	bold
仗勢欺人	bracket
他稱	bracket
他的媽媽希望 go to 臺科大	bracket
他有30cm	bracket
他是北越的	bracket
他是全中國最有名的魔術師，小平叔贏橋牌，還得靠他。	bracket
他敢明天動 我就甲扮聖誕老人跑台灣大道一趟	bracket
他好像永遠對著你笑，笑得你心裡發寒	bracket
他國事務	bracket
今日yoh	bracket
今天的阿福令人舒服	bracket
今天是趙敏要張無忌到大都救六大派的20周年	bracket
今天又是平靜的一天	bracket
今天又是不用不用（或ぴょんぴょん）的一天 = =	bracket
今天又是不用不用的一天 = =	bracket
今天不可能封王拉 今天封王我喝機油100mL	bracket
仇女板	bracket
仇女文	link_title
仇女	link_title
什麼是越位？	bracket
什麼是越位	bold
什麼是天元？	bracket
什麼叫初音是個軟體而已.....想決鬥嗎？	title
什麼叫初音是個軟體而已.....想決鬥嗎	bold
什麼	bracket
人類喝機油會怎麼樣嗎？	bracket
人蔘	bracket
人肉搜索	bold
人肉	bracket
人緣不好	bracket
人生	bracket
人氣	bracket
人正真好、人帥真好、一定不正、一定不帥	bold
人正真好	bracket
人帥真好	bracket
人家森77	bracket
人家是男森ㄝ	bold
人家是女生也	bold
人家是女森ㄝ!	bold
人人買中鋼	bracket
人人有功練	bracket
人中呂布	bold
人+4	bold
亮亮女神	bracket
亮亮之亂	link_title
亮亮	bold
京都念慈庵	bracket
京花交通	bracket
亦伸文	link_title
交通類板	link_title
交談	link_title
交大資工次世代	link_title
亡國感好重	bracket
亞美跌	bracket
亞美蝶	link_title
亞洲統神霸氣登場	bracket
亞洲統神	link_title
亞洲人	bracket
井然有序	bracket
五霸	link_title
五毛	link_title
五樓跟xxx在一起	bracket
五樓請給分	bracket
五樓請回答	bracket
五樓被一樓XX	bracket
五樓自肥	bracket
五樓自宮	bracket
五樓自婊	bracket
五樓的大大	bracket
五樓梗	link_title
五樓我們下禮拜再見	bracket
五樓專業	bracket
五樓姆咪 全家都姆咪	bracket
五樓吃屎	bracket
五樓你說呢？	bracket
五樓你好糟糕	bracket
五樓中肯	bracket
五樓30mm	bracket
五樓	link_title
五月天能否成為披頭四	bracket
五月天早生30年有辦法超越披頭四的八卦	bracket
云木	bracket
二次元妹控	bracket
二七事件	link_title
事情已無法挽回	bracket
事後想想不對	bracket
事件	link_title
了不起，負責	bold
了不起。負責	bracket
亂碼文	link_title
亂碼	title
亂源	bold
亂板	link_title
亂問	bracket
乳頭推	bracket
乳蛇	bracket
乞丐	bracket
九品芝麻官	link_title
乙太公zsh	title
乙太公	link_title
么告	bracket
么吉	bracket
乃哥	bracket
主角與雜魚	bracket
主要關鍵字之亂	link_title
主要在FB	bold
主耶穌的寶血塗抹潔淨!!聖靈的活水沖洗乾淨	bracket
主人，這閃光彈連我都瞎了	bracket
丹丹之亂	link_title
丸把刃	link_title
中鋼丁	bold
中鋼j表示：	link_title
中鋼j	link_title
中部粽	link_title
中華隊贏球	bracket
中華民國與越南斷交	bold
中華民國將與越南斷交	bold
中華民國啦幹	bold
中華一番周末 LIVE 閒聊文	bracket
中華一番	link_title
中興大學板	link_title
中肯（台肯、華肯）	title
中肯	link_title
中立理性選民	bold
中立	bracket
中洨	bold
中水球	bold
中校條款	bracket
中校	link_title
中指蕭事件	link_title
中客	bracket
中央	bracket
中大	bracket
中壢李姓選民	bold
中國科技大學板	bracket
中國猶太人	bracket
中國是他國	bracket
中國或成最大贏家	bracket
中國「帝吧」與PTT	title
中國	link_title
中南王	bracket
中共派軍機轟炸總統府	bracket
中二用語	bracket
丟水球	bold
丞相，風起了	link_title
丞相，起風了！	bold
丞相，起風了	bracket
丞相起風了	link_title
丞相…	bracket
世紀帝國II	bold
世界上最遠的距離     不是南極到北極 ，而是從武當到大都的距離	bracket
不雅字眼或不雅暱稱稱呼球員	bracket
不錄了不錄了	bold
不該失火的地方	bracket
不解釋	bracket
不要起爭議啦	bracket
不要讓勝文不開心	bracket
不要讓XX不開心	bold
不要誤會，我不是針對你啊，我是說在座的各位都是垃圾	bracket
不要秀下限好嗎？	bracket
不要白費力氣了	bracket
不要富奸化啊	bracket
不要問！很恐怖！	bold
不要問！很可怕！	bold
不要問	bracket
不要以為道歉時露出胸部就沒事了	bracket
不行	bracket
不自殺聲明	link_title
不能只有我看到	bracket
不簽聯絡簿	title
不管有甚麼危機 做老爸的一定會想辦法幫你撐著的阿	bracket
不管她嗑了什麼，都給我來一份	bold
不管你們信不信，反正我是信了	title
不管他嗑了什麼都給我來一點	title
不知所云	bracket
不當選	bracket
不當更動帳號數值管理辦法	link_title
不用不用	bracket
不爽不要看	bracket
不爽不要用	bracket
不爽不要玩	bracket
不爽不要投	bracket
不爽不要做	bracket
不爽不要__	bold
不爽不要X	title
不然你要投國民黨？	bracket
不然你要投國民黨嗎	title
不演了不演了	bold
不演了	bold
不會	bracket
不是馬良失街亭嗎？	bracket
不是118還敢討論臺科大	bracket
不斷表示要版友刺迷"認清事實"，直言馬刺不行了，教練爛、Manu/RJ爛	bold
不懂粉絲幹嘛搞撕裂	bracket
不意外	bracket
不想跟你計較	bracket
不想解釋	bracket
不応期	bracket
不忍噓	bracket
不屑解釋	bracket
不對啊，今年不是五倍嗎？	bracket
不容質疑你的XX	bold
不客氣了	bracket
不好笑笑話	bracket
不好的事	bracket
不喜歡	bracket
不可質疑你的神	bracket
不可質疑你的五六	bracket
不可質疑你的XX	bold
不可試探你的神	bracket
不可能羈押成功拉 今天羈押成功 我吃十個隨身碟	bracket
不可理解、笨	bracket
不可強迫別人接受祝福	bracket
不受歡迎人物	link_title
下體	bracket
下週五啦	bracket
下週五	bracket
下述的觀念差異	link_title
下載	bracket
下跪	link_title
下禮拜處理	bracket
下禮拜五到底何時才會到？	bracket
下禮拜五	bracket
下星期五會有什麼事發生嗎？	bracket
下星期五	bracket
下推文，澄清關於有傳聞說自己娶日本老婆一事是假的	bold
下巴推	bracket
下巴保密協定	bracket
下去領500	link_title
下去領300塊	bold
上酒	bracket
上車	title
上色模式	link_title
上等人	bracket
上站次數	link_title
上站天數	link_title
上站人數	link_title
上海王	bracket
上帝	bracket
上岸	link_title
上印記	bracket
三金板（Golden-Award）	title
三金板	bold
三重劉德華	bold
三角洲	bracket
三立板（Set）	title
三立板	bold
三熊圖	link_title
三杯	bold
三朝★身寸☆惹ㄦ obov	bracket
三寶飯	bracket
三寶不意外	bracket
三寶	link_title
三國板	link_title
三國時代吳和蜀為何難有聯合軍事行動?	bracket
三哥之亂	link_title
三句話總結XXX	link_title
三位一體	bracket
七種傳說的廚具之一	bracket
七之亂、小雪之亂	link_title
七之亂	link_title
丁工乙乙	bracket
丁丁是個人才	link_title
一顆星	bracket
一行文	bold
一群人玩神奇寶貝	bracket
一秒	bold
一發即被攻訐，甚至連本名、系所、工作都被肉搜翻出	bold
一流的吐槽家、二流的美食家、三流的小說家跟不入流的史學家	bracket
一樓測風向	bracket
一樓你完了	bracket
一樓	link_title
一條苦瓜	bracket
一朗與他的快樂夥伴	bracket
一日球迷	link_title
一定不正	bracket
一定不帥	bracket
一切盡在不言中	bracket
一切合法、合理	bracket
一分鐘戰神	bold
一分蘇	bracket
一分瑩	bracket
一個變了心的女人什麼都幹得出來	bracket
一個便當不夠你不會吃第二個嗎？	bracket
一個xx不夠你不會X第二個嗎？	title
一個xx不夠你不會X第二個嗎	bracket
一人一百救主機	bracket
一九八二年，打贏了日本重砲手雷龍！接著連續三年打敗日本所有空手道高手，贏得全日本自由搏擊冠軍，中國古拳法！被譽為空手道的剋星！綽號魔鬼筋肉人！	bracket
㊣咩板主™偽娘	bracket
ㄏㄏ、頗ㄏ、根本ㄏㄏ（頗呵、根本呵呵、頗喝）	title
ㄏㄏ、頗ㄏ、根本ㄏㄏ 、根本頗ㄏ，或作頗呵、根本呵呵、頗喝	bold
ㄏㄏ	bracket
ㄎㄎㄎㄎㄎㄎㄎㄎㄎ	bracket
ㄈ仔	link_title
ㄈㄓ	bracket
ㄈㄈ尺正夯	bracket
ㄈㄈ尺	bold
ㄈQ	bracket
マ‧クベ	bracket
ネタバレ	bracket
デブでオタク	bracket
やめ！やめ！	bracket
やめて	bracket
めしょうがんも	bracket
〒△〒	link_title
【馬皇降臨】台大PTT站方全面禁止點播馬英九下台系列歌曲【和諧】	bracket
「祭品」	bold
「沒那個屁股就不要吃那個瀉藥!! 不懂日文就不要去玩神奇寶貝!!!!!」	bold
「妳這個小壞壞～妳這不是見到我了嗎」	bold
「妳這個小壞壞～妳可以圍住兩分鐘，真不簡單」	bold
「只要依序收服 A-Z 不同的未知圖騰，就可以啟動密技、提高神奇寶貝等級最大上限到 200 等」	bold
「加分」文	link_title
「你跟仙劍的	bold
「今天或許會有人說『 不懂日文也能玩 PAD 呀，你沒玩過神奇寶貝嗎 ?』」	bold
「一整季只用清水洗澡或擦澡	bold
《戰女》文	bold
《BBS鄉民的正義》	bold
、拉美王	bold
、之亂	link_title
★★支那人是全世界最低等.最低能.最骯髒的種族★★	bracket
◢▆▅▄▃ 崩╰(〒皿〒)╯潰 ▃▄▅▆◣	title
↖★煞氣a小煞☆↘	title
→ netalosi:板上一片護航聲，難道不會讓有志難伸的寫手萌生去意嗎?	bold
→ netalosi:有消息說2120接了NBAGM板後要走	bold
……聊聊某車站吧	bracket
……………笑 話……………	bracket
”吃金針菇	bracket
Κ先生專欄	bracket
zuyi	link_title
zombiepigman	link_title
zoeforce	link_title
z9怎麼一夕之間就黑掉了	bracket
z9之亂	bracket
z9	link_title
z5	bracket
yunjin	link_title
yumi之亂	link_title
yuilingo	bold
yoyo大師	bold
yoyodiy	link_title
yoyo	bold
yorkyoung (約克羊)	bold
yorkyoung	link_title
ya哥？是你？	bracket
ya哥事件	link_title
ya之亂	link_title
yayakaka	link_title
yamiyugi	bold
xx重工	bracket
xxx連撞豆腐自殺的勇氣的沒有	bracket
xxx是魯蛇的行為	bracket
xxx不如自盡吧	bracket
xxxx是標準魯蛇的想法	bracket
xxxx5566	bracket
xxxx 該注意什麼？	bracket
xxx	bracket
xin	bold
xiaomiao	link_title
xbeyond	link_title
wwwwwwwww	bold
wweibird	bold
wuke	link_title
wow版	link_title
wow板	link_title
words2012	bold
wondafrog	bold
womentalk板	link_title
womentalk	link_title
women talk版	link_title
wikipedia:zh:浮竹十四郎	link_title
wikipedia:zh:死神	link_title
wikipedia:zh:本票	link_title
wikipedia:zh:仙人跳	link_title
wens	link_title
wen750711	link_title
weichipedia	link_title
wego	link_title
warcraft版	link_title
warcraft板	link_title
wanted板	link_title
wanted	link_title
walile954	bold
vvvccc1d	link_title
violation版	link_title
verylike5566	link_title
vanhalen	link_title
valender	link_title
uu26793	link_title
user:hijkxyzuw	link_title
unya	bracket
underwear板	link_title
umbilicus	bracket
uland26922	link_title
tzunghan	link_title
typeking	bold
twod758	link_title
twod	link_title
tutsau#這個部落格看了很想死	link_title
tusbaki	link_title
ttb我要（想）幹（X）死你	bracket
ttb我要幹死你 T_T	bracket
ttb 約炮醜聞	link_title
ttb 我想幹死你	bracket
ttb	link_title
tsungmou1	bold
trangender板	link_title
tos板	link_title
tos	link_title
tonytsou912	bold
tomchen60229	bold
tigotigo	link_title
tiger1201	link_title
they	bracket
theRock 都講完了，我跟 theRock 想法差不多	bracket
theRock	link_title
tempchat	link_title
tcbus	bold
tattoo_ring板	link_title
talk板	link_title
talk5566	bold
talk520	link_title
talk	link_title
take dollar	bracket
tacabro - tacata	bracket
t2d	bold
sysop板	link_title
swattw	link_title
sumade	bold
suckcomic板	bold
streamerc	bold
starcraft板	link_title
staff23	link_title
st900278	bold
spurs2120開始將文章只放在友人所經營的FB"	bold
spurs2120與眾多寫手或評論圈積極親近，保有好交情，有龐大的優質寫手	bold
sorry	bracket
sohandsomeim	bold
sluttysavage	bold
slow	bracket
sleeeve	link_title
skyjizz	bold
skyjazz	bold
skybear	link_title
sivhd	link_title
shoda	link_title
sex板	link_title
sexy5566	link_title
sexkinsey	link_title
sexbox	link_title
sex	link_title
setzer	bold
serraliu	bold
septhsu	bold
seebox	link_title
seba	bold
seanlien	bold
seal online板	link_title
seabox	link_title
sallykoi	link_title
s89227	bold
root (系統總監)	link_title
ronnywang	bold
rest in peace	bold
remorse	link_title
realtw	bold
raindog	bold
qxxrbull	link_title
queenhashin	bold
qscxz	bold
qn	link_title
qazieru	link_title
q5123123	link_title
p幣	link_title
pushdoll	link_title
push doll版	link_title
push	bracket
ptt電台	link_title
ptt關站	link_title
ptt量販店	link_title
ptt鄉民認同卡	bold
ptt網頁版	bold
ptt系統權限異常事件	link_title
ptt第二屆流行語大賞	link_title
ptt第2屆流行語大賞	link_title
ptt第1屆流行語大賞	link_title
ptt是反指標	bracket
ptt故障	link_title
ptt掛掉	link_title
ptt掛了	bold
ptt官階	link_title
ptt名人集	link_title
ptt史上第一個賄選被抓的人	bracket
ptt十大情人	link_title
ptt創建	link_title
ptt前站長入侵資料事件	link_title
ptt五霸	link_title
ptt三大神器	link_title
pttradio版	link_title
pttonline.cc	link_title
ptthistory版	link_title
ptthistory	link_title
pttfamous板	link_title
pttCard版	link_title
ptt2	link_title
ptt.m8.ntu.edu.tw	bracket
ptt 是什麼	bracket
ptt 三神器	bold
ptt 三大神器	bold
ptt web版	bold
ptt web板	link_title
ptt card	bold
prozac	link_title
po文章得鑽石	bracket
po文	link_title
po廢文	bracket
posted from android bbs reader on my Nokia 3310	bracket
poloyabi	bracket
plumage	bold
play one	bracket
plant板	link_title
pilot7	bold
peter1	link_title
pcman	link_title
p1好了嗎？	bracket
oz5566	link_title
overkill0802	link_title
over post	bracket
ott	bold
orz	link_title
oricaa、cosmoschoen、gorgeous216	bold
oricaa	bold
okcool	link_title
okccol	link_title
oh no	bracket
ocean5566	link_title
obov	link_title
nothisman	link_title
nothismam	bracket
nono照片事件	link_title
nokia3310	link_title
ninima	bold
new iPad	bracket
nba板	link_title
nCoV2019板	bold
nCOV2019板	link_title
m的文章	link_title
m文	link_title
mtvabc	link_title
mrp	bold
movie版	link_title
movie板	link_title
mousepad	link_title
mother	bold
morrischen2	link_title
moptt	link_title
mini158事件	link_title
mini158之亂	link_title
mini158	bold
mini	bold
millia62219	bold
meowmeowgo	link_title
mentalk的出氣包	bold
mentalk版	link_title
mentalk板	link_title
mentalk	link_title
medstudent板	link_title
mayaman	link_title
maxmaster	bold
mature	bracket
masage	link_title
marvel板	link_title
marvel	link_title
marubou	bold
marriage	link_title
markban	link_title
mark2165	link_title
makiyo事件	link_title
madguy	link_title
ltnsltns	link_title
lovesooman	link_title
louisman	bold
loser	bracket
longbow2	link_title
lol版	link_title
lol板	link_title
lol	link_title
log	bracket
local moms need cock	bracket
lladro	link_title
live文	link_title
live	bracket
liliumeow	bold
lifespan	bold
lidance	link_title
liaolive	link_title
lesbian板	link_title
leesmart	bold
lag很大	bracket
lag了	link_title
la new熊版	link_title
k島	link_title
k少	link_title
k大	link_title
kuso 板	link_title
kuso	link_title
kurtc	bold
kuopohung	link_title
korking52013（大將軍）	link_title
korking52013	bold
kodomo板	link_title
kobe	link_title
kinple	link_title
không	bracket
kfclikeshit	bold
kero2377	link_title
kay731	link_title
kasion	link_title
kamiyu	link_title
kai5566	link_title
jzs	link_title
junjikilin	bold
jschenlemn	link_title
joke等版	link_title
joke版	link_title
joke清流	bracket
joke板	link_title
joke已死	bracket
joke之神	bracket
joke	link_title
jky823	bold
jjjjjs	bold
jizz	bracket
jimmyduh	link_title
jason841207	link_title
japanavgirl版	link_title
jacky66666	link_title
jacklyl	link_title
ipobar	bold
iphone板	link_title
iphone8ss	bold
ipad3	link_title
ip	link_title
ioupoiu	bold
iorifox	bold
intel#擠牙膏	link_title
intel#外星人	link_title
intel	link_title
in2	link_title
ilove05	bold
ikarih	link_title
idcc體	bold
idcc	bracket
iPhone板	link_title
iPad3 第四屆八卦板主任期 2014/07/19 ~ 2014/10/31	bold
iPad3 第六屆八卦板主任期 2014/11/01~ 2014/12/31	bold
iPad3 第八屆八卦板主任期 2015/07/01 ~ 2015/09/14	bold
iPad3	link_title
hy654	link_title
hy	bold
home-sale板	link_title
hint: ↘	bracket
hill0708	link_title
hiimlive (僞娘)	link_title
hiimlive	link_title
hero9999	bold
hate點	bold
hate版	link_title
hate板	link_title
hate文	bold
hateonas	link_title
hateOnas (檢舉王)	link_title
hateOnas	link_title
hao123	bold
hail obov	bracket
gy5566gy	link_title
guohuo	link_title
gun5566	link_title
griffinj9	link_title
gp/bp	bold
google8494	bold
goodstars板	link_title
goodman1985開始被貼上反串、刺黑、反Duncan的標籤，開始被特定版友攻擊	bold
goodman1985憤而離開Spurs版	bold
golf jane	bracket
gn01765288	bold
giddens	link_title
ggininder	bracket
gginin	bold
gg	bracket
gay板	link_title
gaybar	link_title
gauyi	link_title
gaiaesque	link_title
g6m3kimo	bold
fuxkyou	bold
fuunshing	link_title
freeunixer	bold
freeread	bold
formatted	link_title
flyingwhale	link_title
fleeaaa	link_title
fishyfish	bold
firsthand	bold
ffwind	link_title
ffaarr	bold
feelar	bold
fatlip	bold
farro	bold
fanfantu2014	link_title
famousword板	link_title
facebook	link_title
f7	link_title
eternityring	bold
emailyang板	link_title
email5566	link_title
e-shopping版	link_title
e-shoping板	link_title
dudeboy	link_title
drawing板	link_title
dosandonts 中姊姊	bold
dosandonts	bold
doohdlihc	link_title
donate-blood板	link_title
disp bbs	link_title
disFabulous	link_title
dieinvisible	bold
diefishfish	link_title
dicfishfish	bracket
diablo板	link_title
deserts	bold
der	bold
dcard	link_title
dance板	link_title
cute	bracket
cu0920	link_title
ctrl+u	bracket
csir	link_title
credict	bracket
cpblgu (中職菇)	bold
cpblgu	link_title
cool down	bracket
comsboy	link_title
clubT	link_title
cloudlaba	bold
closefeather	link_title
circuskid	bold
cherish18	bold
chairmanmao	link_title
cellur	bold
ceca	bold
ccrnogood	link_title
ccr	link_title
cckcc	bold
caterlanse	bold
catch板	link_title
carhow	link_title
c-chat	link_title
boyo	link_title
bluwoo	link_title
blueskydoor	bold
bluesky0226	bold
blueeyes0622	bold
blizzard2002	bold
blaz	bold
bj4	link_title
birthday板	link_title
billchen0905	bold
biker板	link_title
bigbighead	bold
belleaya	bold
beef	link_title
beauty版	link_title
beauty	link_title
bbsmovie板	link_title
bbsmovie	link_title
bbsadm	link_title
bbs.m8.ntu.edu.tw	bracket
bbs movie	link_title
bb633633	bold
battlegirlhs板	link_title
baseball	link_title
balaja	link_title
badjye911	link_title
babymother板	link_title
av 板	link_title
ask板	link_title
askboard板	link_title
asiagodtone	bold
arsonlolita	link_title
armour	link_title
apologize	bracket
ansiProject	link_title
anglegirl13	link_title
angel07	bold
andy810625(ㄎ_ㄖ)	link_title
amoses	bold
alt	bracket
allyours	link_title
aliconcon	bold
albb0920	link_title
ac4r	link_title
abian5566	link_title
a6234709	link_title
a27788987	bold
a234john168	link_title
a000000000	link_title
^Q^	bracket
\洨當家/\洨當家/\洨當家/	bracket
[ＸＤ] 警察辛苦了！	bracket
[ＸＤ] bing真的有病	bracket
[ＦＢ]盧勁軒	bracket
[閒聊] 隨手附圖	bracket
[閒聊] 玩水	bracket
[閒聊] 完全黑掉的ID有什麼用途？	bold
[討論] 男友睡旁邊卻不嘟	bracket
[討論] 暗黑界的張景嵐	bracket
[耍冷] 他走了	bracket
[神人] 妹子	bracket
[猜謎] PO廢文被張景嵐噓 猜一成語?	bracket
[爆卦] 第一次面對訟棍就上手	bracket
[爆卦] 有沒有劈腿還義正嚴詞的八卦？	bold
[爆卦] 今天是賭神高進妻兒逝世20週年	bracket
[爆卦]	bracket
[無言] 下一句是什麼?	bracket
[灑花] 看到obov引退超開心 來發P	bracket
[正妹] 2013台北國際車展-超級名模!!	bracket
[歐麻吉]整人電話 黑人哥搶女友	bracket
[新聞] 圓仔體重逼8公斤 小爪子力氣大	bracket
[新聞] 圓仔銳利小爪子 保育員怕怕	bracket
[心得] 還是印尼好	bracket
[心得] 用素肚打手槍	bracket
[心得] 戰鬥服心得﹝上﹞	bracket
[彩券]	bracket
[外絮] AZU TPA mistake godjj代打	bracket
[問片]摩根費里漫演的一部片	bracket
[問卦]有沒有味噲湯裡的魚吃起來都臭臭的八卦	bracket
[問卦]太正晶又嚴肅的女生 如何讓她產生興趣	bracket
[問卦] 靜香沒有女生朋友？	bracket
[問卦] 身邊有沒有一種人?	bracket
[問卦] 美國真的充滿歧視嗎	bracket
[問卦] 發文附圖好嗎	bracket
[問卦] 有肺紋的八卦嗎?	bracket
[問卦] 有沒有靠釣魚告人賺錢的八卦	bracket
[問卦] 有沒有集滿七顆的八卦?	bracket
[問卦] 有沒有辜莞允私底下為人的八卦?	bracket
[問卦] 有沒有藍染的八卦	bracket
[問卦] 有沒有等公車熱褲妹的卦？	bracket
[問卦] 有沒有硬要用學校IP發廢文的八卦	bracket
[問卦] 有沒有熱舞考試短褲妹的卦？	bracket
[問卦] 有沒有微波食物短裙妹的卦？	bracket
[問卦] 有沒有大同電鍋的八卦?	bracket
[問卦] 有沒有外送飲料緊身裙妹子的卦？	bracket
[問卦] 有沒有圖王身分似乎暴露的八卦?	bracket
[問卦] 有沒有同性戀依然不被接受的八卦?	bracket
[問卦] 有晚上台中什麼東西好吃的八卦嗎?	bracket
[問卦] 搖擺屁股蛋妹的八卦?	bracket
[問卦] 妹子的腳趾都是香的嗎?	bracket
[問卦] 如何匡正晶日天下之亂	bracket
[問卦] 台女嫁到日本好像都不幸福	bracket
[問卦] yoyodiy有辦法繞過街亭嗎	bracket
[問卦] yoyodiy有辦法繞過發壓歲錢嗎?	bracket
[問卦] IP不是140開頭的是哪些學店?	bracket
[哇靠]	bracket
[公告] 請自肅	bracket
[公告] XXX 樂透開獎	bracket
[公告] XXX 樂透取消	bracket
[公告] XXX 板 開始舉辦樂透!	bracket
[備註]	bold
[kuso] 神隱少女	bracket
Z＞B	title
Zrola	link_title
ZenUp (陳穎)	title
ZenUp	bold
ZZZZZZZZZ9（Z9大神、神龍）	title
ZZZZZZZZZ9	bold
Z9大神	bold
Z9	link_title
Yoyodiy	title
You see see you	bracket
Yorkyoung(約克羊)	title
Ya之亂、校園裡單純的愛情?! 事件	link_title
Yayakaka	title
YUreo	title
YU0121	link_title
YOOOOOOOOOO！！	bold
YOLO板	title
X樓請洽jay板	bracket
X樓救援成功	bracket
X樓救了這篇文章	bracket
X樓尚書大人	bracket
X樓好笑	bracket
X樓和X樓救援成功	bracket
X樓GJ	bracket
X媽媽婚友社	bracket
X大	bold
X啦幹	bracket
X了又X	bracket
Xrays	bold
Xin（高嘉瑜）	title
Xiaomiao（苗博雅）	link_title
Xavy	link_title
XX？是你？	bold
XX，是你？	bracket
XX都是很nice的..我想這中間一定是有什麼誤會	link_title
XX臭了嗎？	title
XX站出來	link_title
XX的霸主	bracket
XX炸裂	bracket
XX海沒加蓋	title
XX是不是過譽了	bracket
XX是不是過氣了	bracket
XX文	bracket
XX打球	bold
XX才是本體	title
XX我老婆	bold
XX我可以	bold
XX必須死	bold
XX女神在五樓床上	bracket
XX國發現大規模毀滅性武器	bracket
XX國有大規模毀滅性武器	bracket
XX元年	bracket
XX之光	link_title
XX中的霸主…還是XX	bold
XX不意外	title
XXX表示	bold
XXX與他的快樂夥伴（們）	title
XXX與他的快樂夥伴	bold
XXX與他快樂的夥伴	bracket
XXX的日常、	bold
XXX的形狀	title
XXX炸裂	bracket
XXX正妹 第XX彈	bracket
XXX是在秀下限嗎？	bracket
XXX是什麼咖啊，OOO就跩上天了	bold
XXX我愛你	bracket
XXX必須死	bracket
XXX就在你後面 他現在很火	bracket
XXX在秀下限	bracket
XXX在想什麼	bracket
XXX在你後面，他非常火	bold
XXX出軌	bracket
XXX你好糟糕	bracket
XXX不意外	bold
XXXXX，你我都推了一把	bracket
XXXXSHIT	link_title
XXXXGAY（四叉貓、四X貓）	title
XXXXGAY (四叉貓)	link_title
XXXXGAY	link_title
XXXXCAT	link_title
XXX.......是不是?	bracket
XXX+1	bracket
XXX 的形狀	bold
XXX 當選	bracket
XXX	bracket
XX 悲歌	bold
XX	link_title
XP再戰十年	bracket
XDDDDD…	bracket
XDDDDDD	bracket
XDDD	bracket
XD	link_title
XBOX	link_title
X=俊， D=朗	bracket
Wwwwwwww	title
Wweibird（韋禮安）	title
Wuyiulin	title
Wtaa（窩塔）	title
Wtaa	bold
Wow板	link_title
Wondafrog	title
Womentalk板	link_title
Womentalk 板主洩密事件	link_title
Womentalk	link_title
WomenTalk板	link_title
WomenTalk	link_title
Womantalk 板主性騷疑雲	link_title
What the fuck am I reading	bracket
Wanted	link_title
Walile954（左光平）	title
WOW板	link_title
WARgame723	title
Violation板 (違規檢舉中心)	title
Violation	link_title
Venti（童話王）	title
VVizZ	title
VVVV5555（耀揚哥）	title
VVVV5555	link_title
VIP帳號	bold
User:Ffaarr	link_title
Ultratimes	title
Uhawae（好屌）	title
Uhawae	bold
UCCU	link_title
Typeking（打字王）	title
Turtao	link_title
TuTsau	bold
Ttb	title
Tswyhml	title
TsushimaRiko(津島梨子)	title
TsushimaRiko	link_title
Tsungmou1 (忠孝)	title
Tsukiyomi157	title
Trance	bracket
Tos板	link_title
Tomchen60229	title
ToS板	link_title
Tiger1201	title
TheNewiPad	bracket
The Story of Robin Hood and His Merrie Men	bracket
TempChat板 (臨時心情抒發板)	title
TempChat板	bold
Telnet	link_title
Tcbus（社后、吳國長三角君）	link_title
Talk板	link_title
Takeda5566	bold
Taiwandrama	link_title
TaiwanIsDog	link_title
TaiwanDrama	bold
TWICE板	link_title
TPCMAX（左岸沉思）	title
TPCMAX	bold
TOS	link_title
TANet	link_title
T683	bold
T2d	title
T o m o y o	bracket
Sumade（蘇美戰神）	link_title
Suckcomic板（漫吐板、漫畫吐槽板）	title
Streamerc（石沐凡）	title
Stevenjeff 傑夫	title
St900278	title
Spurs2120及刺版紛爭	title
Spurs2120	title
Sorry	bracket
Sohandsomeim	title
Soft_Job板	link_title
Slow（楊蕙如）	title
Skyjazz	title
SkyMirage（天哥）	title
Sizumaru（藏書界竹野內豐）	link_title
Sizumaru	bold
Sieg G 嗡	bracket
Sex板	link_title
SexKinsey（西斯板匿名帳號）	title
SexKinsey	bold
Sex	link_title
Setzer	title
SetsunaLeo	bold
Septhsu（徐展元）	title
Sent from my android	title
Sent from JPTT	bracket
Seba（蝴蝶）	title
Seanlien（連勝文）	title
Seabox	bold
Saxon	link_title
Safelove	title
SYSOP板 (站長板)	link_title
SYSOP	link_title
SSD重組	title
SSD 固態硬碟	bold
SSD	link_title
SNSD	link_title
SEX版	link_title
SENIORHIGH	link_title
SD-GundamOL、SEX板	link_title
S110342	title
Ryushuier （流水兒）	title
Ryushuier	bold
Rrr518	title
Ronnywang （榮尼王）	title
Ronnywang	link_title
Ricas	link_title
Rhodenbarr	link_title
Remorse	title
Realtw	title
ReDmango	title
Re: 原文章標題	bracket
Re: [討論] 剛剛搖好大	bold
Re: [童年] 童年的遊戲--仙劍奇俠傳	bracket
Re: [問卦] 妹子穿這麼露 是在透露交配的訊息嗎?	bracket
Rambo	bold
RaferAlston	link_title
RS5566	link_title
RESIT	link_title
RAPEKING56	link_title
R: 原標題	bracket
R13北車	bracket
R.I.P.	bold
Qscxz（奈米哥）	title
Qn	title
Qbian	link_title
Q_ary板	link_title
QQMMWA	title
QQ	link_title
Q5123123	title
P幣	link_title
Python	bold
PuzzleDragon板	link_title
Pushdoll	link_title
PushDoll板	link_title
Ptt鄉民認同卡	title
Ptt鄉民的性別比例	title
Ptt鄉民晚報	bold
Ptt鄉民公布李宗瑞淫照事件	link_title
Ptt與賭神	title
Ptt與訴訟（網路訟棍事件）	title
Ptt站名（由來及意義等）	title
Ptt掛了（ptt故障、關閉）	title
Ptt慈善水桶王大賽	link_title
Ptt五霸	link_title
Ptt三大神器	title
Pttonline.cc	title
PttNewHand板	link_title
PttEarnMoney板	link_title
PttAntiBot板	link_title
Ptt web版、ptt網頁版	title
Ptt	bold
Professional　Techonolgy　Temple	bracket
Po文	link_title
Plumage（阿信）	title
PlayStation	link_title
PlayBoss（王仁甫）	title
PlayBoss	bold
Perl板	link_title
Pcman（洪任諭）	title
Pcman	link_title
Patiencel	title
Panda Tu	bracket
Palmar_Drama板	link_title
PUMA	bold
PU	bracket
PTT（杜奕瑾）	link_title
PTT風雲人物投票	title
PTT鄉民的世界觀	title
PTT鄉民百科	link_title
PTT鄉民有約	link_title
PTT鄉民日曆	title
PTT運動員綽號列表	link_title
PTT藝人綽號列表	link_title
PTT與《破壞之王》	title
PTT籃球員綽號列表	link_title
PTT站名	link_title
PTT看板分類	link_title
PTT看板	link_title
PTT相關事物	link_title
PTT的成立	title
PTT的各類文章	title
PTT流行語大賞	title
PTT流行符號	link_title
PTT流行用語	link_title
PTT歷史大事表	link_title
PTT棒球員綽號列表	link_title
PTT最新訊息-列表	title
PTT最新訊息	link_title
PTT文體	link_title
PTT文化	link_title
PTT故障	link_title
PTT政治人物綽號列表	link_title
PTT廢文王	bold
PTT官階	bold
PTT女神	bold
PTT基本用語	link_title
PTT基本功能	link_title
PTT圖片	link_title
PTT名人	link_title
PTT列表	title
PTT停機	link_title
PTT修好了	bracket
PTT佛地魔	bracket
PTT企業綽號列表	link_title
PTT人氣系統	link_title
PTT五霸	link_title
PTT二十周年慶	link_title
PTT事件	link_title
PTT乳神	bold
PTT之神	bracket
PTTradio事件	link_title
PTTOnline	link_title
PTT20週年	link_title
PTT20周年站慶	title
PTT20周年撰寫條目活動	link_title
PTT2	link_title
PTT 名人	link_title
PTT Spurs	bold
PTT 404-Not Found	bracket
PPTplayer	link_title
PPTPlayer	bracket
PO文	link_title
PO初音有關的文章，釣兇宅出來決鬥	link_title
PO	link_title
PH值很低	link_title
PCman	title
PCMan	link_title
PCH800618	link_title
Oz5566	title
OverWatch	link_title
Ott	title
Oilboy	link_title
OdieX	link_title
Obov（身寸☆惹ㄦ）	title
Obov	link_title
OP	bold
OOO是 XX中的霸主…還是xx	bracket
OOO就跩上天了	bracket
O2板	link_title
O' 'o	title
Nothisman（藍染王）	title
Nomorepipe	bold
Nokia 3310	bold
Ninima（呱吉）	title
Nevar	link_title
Neptunium	link_title
NCoV2019板	title
NCKUkober（成大狗鼻哥）	title
NCKUkober	bold
NBA版	link_title
NBA板	link_title
NBAeasychat	link_title
NBAdog（鐵手套、藏獒）	title
NBAdog	bold
NBAcat	bold
NBA_film板	link_title
NBA	link_title
Mtvabc	title
Mrp(小生)	title
Mother	title
Morrischen2（六百萬）	title
Morrischen2	link_title
Moptt	link_title
MoPTT屏蔽JPTT簽名檔事件與Mo之亂。	link_title
MoPTT屏蔽JPTT簽名檔事件與Mo之亂	link_title
MoPTT	link_title
MoNeNe	bold
Mini158	title
Militarylife	link_title
MiharuHubby	title
Microscft	link_title
MicroGG（骨科大）	title
MicroGG	bold
Mews (海鳥)	title
Mews	link_title
Merry Men	bracket
Mentalk板	link_title
MenTalk	link_title
Meme	link_title
Mayaman（馬雅人）	link_title
May show gun more?	bracket
Max大大	bold
Maxmaster（Max大大）	title
Maxmaster	link_title
Mature: 你沒有被刪文我吞陳為廷的襪子兩雙	bracket
Marvel板(媽佛板)	link_title
Marvel板 (媽佛板、飄板)	title
Marvel板	link_title
Marriage板	link_title
Marginalman板 (邊緣人板)	title
Marginalman	link_title
MarginalMan	link_title
Makotoyen	link_title
Makiyo打人事件	link_title
Makinoyui	link_title
Machadango（抹茶糰子）	title
Machadango	bold
MLB板	link_title
MEWS	bold
MC美江	bracket
MC敏鎬	bold
MAC板	link_title
M 起來	title
Lukaka	link_title
Lturtsamuel	title
Lovesooman（亮亮）	title
Lovesooman	bold
Lovelive_sip	link_title
LoveLive_Sip	link_title
Louisman（鹿男）	title
Lorenzia（金魚）	link_title
Lorenzia	bold
LoL板	link_title
Live文、實況文	title
Liska	bold
Linceass	title
Liliumeow	title
Liaooo（廖大）	title
Liaooo	bold
Leesmart （大綠）	title
Leeng	link_title
Lebron James	bracket
Latinamerica板	link_title
Laoda	link_title
LaoDa	link_title
Lag了，腿了	title
Lag了	link_title
L_TalkandCha	link_title
LYSanity	bracket
LUB（理由伯）	title
LUB	bold
LOL版	link_title
LOL板	link_title
LOL	link_title
LLsolo	link_title
LGBT_SEX	link_title
L2M（raindog、雨狗）	title
L2M	bold
K島	bold
K少板主	link_title
K少	bold
Kuso	link_title
Kurtc（k大）	title
KuoChingKou	link_title
Korking52013（大將軍）	title
Komica	link_title
Kodomo隱板事件	link_title
Kodomo板	link_title
Kobe開口承認拿81分的那場比賽開始前閱讀了聯合報	bracket
Kobe kobed the woman kobely. He is the kobest kober.	bracket
Kobe	bracket
KingdomHuang版	link_title
KingKingCold	bold
Kimgordon	bold
Kfclikeshit（肯德雞像屎大大）	title
Kay731（K少）	title
Kay731	link_title
Katsuyuki118	link_title
Kasion	link_title
Kamiyu	link_title
KMT黨證	bracket
KMT板	link_title
KLM never do that	link_title
KKC	bold
KID	bold
K7森77	bracket
K 島	bold
Junchoon	link_title
Jptt	title
Joseph	bold
Joke板 (就可板、笑話板)	title
Joke板	link_title
Johnny Cueto	bold
John Cena	link_title
Jjjjjs（中鋼j）	title
Jfsu（水精靈）	title
Jeremy_Lin板	link_title
Jay板	link_title
Japan_travel	link_title
Jaies	bold
Jackymars5（台積哥）	title
Jacklyl	bold
JS抄襲事件	link_title
JPTT	link_title
JJLi	link_title
Ipobar（王浩宇）	title
Iphone8ss（唉鳳八）	title
Ipad3	link_title
Intel	title
Ilyj2012 (麒麟才子)	title
IdolMaster（偶像大師板）	title
IdolMaster	link_title
Idcc體	link_title
Id	link_title
IbakaBlock	link_title
IP正確	bracket
IP推齊	link_title
IP、故鄉、查你IP	title
IPhone8ss	link_title
IPad3（艾佩珊、Lavchi）	title
IP 位址	bold
IP	link_title
IM@S	bracket
ILoveElsa	link_title
ID錯誤	bracket
ID正確	bracket
ID_Multi	link_title
ID_Finance	link_title
IDCC	bracket
ID	link_title
IC卡板（IC-Card）	link_title
Hy654	title
HornyDragon（好色龍）	title
HornyDragon(好色龍)	link_title
HornyDragon	bold
Hiimlive（偽娘）	title
Hiimlive	link_title
Hero9999（林世勇導演）	title
Hate板緊急尋人救人事件	link_title
Hate板 (黑特板、恨板)	title
Hate板	link_title
HatePolitics板 (政黑板)	title
HatePolitics	bold
HateOnas（檢舉王）	title
HateOnas	link_title
Hate	link_title
HEBE	link_title
G軟	bold
Gungu（幹古專用帳號）	title
Guis	link_title
Griffinj9	title
GreenBeret（綠扁帽大）	title
GreenBeret	bold
Gossipping	link_title
Gossiping板 (八卦板)	title
Gossiping	link_title
GossipPicket	link_title
Google翻譯超越41J　每日處理1千億字	bracket
Good Game	bracket
Gn01765288	title
GirlsFront板	link_title
Giddens（九把刀、刃太）	title
Giddens	bold
Gg	link_title
GeminiMan	link_title
GauYi（高義）	title
GauYi	bold
Gasol自盡	bracket
Gasol 你自盡吧！	bracket
Gaiaesque	bold
GTOKevin	bold
GTO 小商人	bold
GGrunrunder	link_title
GGrunrundela	link_title
GGininder	link_title
GGinin	link_title
GGININ、GGININder	title
GGININ	link_title
GG 輪班星人	bracket
GG runrun der	bracket
GG	link_title
G6m3kimo （神父、神木）	title
Fuxkyou（ㄈ仔、賄選王）	title
Frojet	title
Freeunixer	title
Freeread	title
FrankWW	link_title
FoxTz（小狐、北越狐、北越妖狐）	title
FoxTz	bold
Forthelife	title
Forsale	link_title
Formatted	title
Fleeaaa	title
Fishyfish（小百合）	title
Firstshadow	link_title
Firsthand（海產王）	title
FirstShadow	title
Ffwind	title
Ffaarr	title
Feelar（螃蟹王）	title
Fant1408	link_title
Fallred	link_title
FallRed	link_title
FairyBomb	bold
Facebook的ptt相關粉絲團	title
Facebook	link_title
FB假推薦真廣告	bracket
FB使用者	bold
FB	bold
F7（站花、美豔人妻愛撫妻）	title
F7	link_title
F4	bracket
Explosion！	bold
Eternityring（台菜二世祖）	title
Emoji在ptt	title
Emma之亂	link_title
EmailYang版	link_title
Email5566（楊伊湄、sluttysavage、queenhashin）	title
Email5566	link_title
ESunBoy	link_title
END	link_title
DreamYeh	link_title
DragonNest板	link_title
Dosandonts(中姊姊)	title
Dontco	link_title
Done	title
Don't Watch an anime called "Boku	bracket
Disp BBS	bold
Dieinvisible（小wei）	title
Diefishfish（死魚魚）	title
Deserts（安溥）	title
Der	title
DenTisGirl	link_title
Dcard	link_title
DaDa之亂	link_title
DSLR板	link_title
DDRMIX	link_title
DC_sale	link_title
C洽板	link_title
C洽	link_title
Cueto在棒球板	title
Cueto	bracket
Ctrl + w	bracket
Csir	link_title
Cross-post	bold
Cpblgu	title
Connie Talbot	bold
Clywin123	title
Cloudlaba	title
Circuskid（KID）	title
Cigxm	bold
ChinLan（張景嵐）	title
ChinLan	bold
Cherish18（徐巧芯）	title
Chenglap	title
Chendao	title
ChangPa	bracket
Cellur（吳青峰）	title
Ceca	title
Cckcc（印尼王）	title
Caterlanse（卡特蘭大）	title
Carhow（卡好）	title
Carhow	bold
Canson	bold
Cal6732	title
C_chat版	link_title
C_chat板	link_title
C_chat	link_title
C_Chat板	link_title
C_Chat	link_title
C_BOO	link_title
CSSE板	link_title
CP (Cross-Post、跨板多貼)	title
CP	bold
CD中，樓下幫補	bracket
CD中	bracket
CD-Pro2	title
CD	bold
CCR板	link_title
CCR之亂	link_title
CCRomance版	link_title
CCRomance板，或簡稱CCR板，又稱真愛無國界板	bold
CCRomance板 (CCR板、ㄈㄈ尺板、真愛無國界板)	title
CCRomance板	link_title
CCR	link_title
CATCH板	link_title
CATCHIEF	link_title
C-Chat板	link_title
C Chat板	link_title
C Chat	link_title
C BOO板 (西部板、西布板)	title
B大	bracket
Bus	bold
Boyo	title
Boy-Girl	link_title
BoardAnnuce	link_title
Board-Police板	link_title
BlueTuna601	title
Blaz	title
Billchen0905（比爾陳）	title
Bill7437（十里坡劍神）	title
Bignana	link_title
BigSanchung板	link_title
BigSanchung	link_title
Belleaya	title
Beef	link_title
Beauty板 (表特板)	title
Beauty板	link_title
Beauty	link_title
Bb633633（過水流大師兄）	title
Baseball板	link_title
BanG_Dream	link_title
Badjye911(阿三）	title
BOSATA	link_title
BJ4（不解釋）	title
BJ4	bracket
BBS鄉民的正義的前導片	link_title
BBS鄉民的正義概念前導片	link_title
BBS鄉民的正義前導片	link_title
BBS鄉民的正義前導概念片	bold
BBS鄉民的正義	link_title
BBS鄉民小劇場	link_title
BBS動畫	bold
BBSmovie（BBS動畫）	title
BBSmovie版	link_title
BBSmovie	bold
BBSMOVIE	link_title
BBS	link_title
A片	link_title
A大	bracket
A圖王	bold
Aviation板 (航空板)	title
Aviation	bold
Audreytang（唐鳳）	title
Audreytang	bold
Asiagodtone（亞洲統神、桶神）	title
Armour（阿磨）	title
Armour	bold
Apak	link_title
Announce版	link_title
Angel07	title
Android板	link_title
AmigaOS	bold
Amginevar板@PTT2 (PTT2八卦希洽板)	title
Amginevar	bold
Amgine	link_title
Amd	title
Alt+f4	title
AlphaGo之亂	link_title
Alltogether	link_title
Allen524	link_title
AllTogether板，	bold
Aliconcon（阿里空空）	title
Alan4ni	title
Ac4r	title
AV女優版	link_title
AV女優板	link_title
APPLEin5566	link_title
ANSI圖	link_title
ANSI	link_title
AMD	link_title
ALLPOST板	link_title
AI	bracket
ADSL	link_title
AC_In板	bold
AC_IN板	link_title
ACG相關文章	link_title
ACGN文	link_title
ACG	link_title
AC In板(裏洽板)	title
AC In	link_title
AA之亂	link_title
AAATP (洪浩雲醫生)	title
AAATP (我老婆超級棒！)	bold
A27788987 (洨當家)	title
A 車	link_title
A 夢王	bold
=====有情有義分隔線=====	bracket
9n	bold
9527	link_title
94狂（就是狂）	bracket
94狂	bracket
9487	bracket
921的時候 大同電鍋頂住了某戶壓下來的樑柱 救了4條命	bracket
9.2%	link_title
9.2	link_title
8A版	link_title
87桶神	bold
87分，不能再高了	bold
87%相似	bold
87%像	link_title
87%	link_title
87	link_title
85%台灣人有房	bracket
8000貓	bold
80	bracket
8.7分	bold
8+9=17歲	bracket
8+9=17	bracket
8+9+17=34	bracket
8+9	link_title
7起來！	bracket
78+9=87	bracket
74團	bold
7.77	title
689、609	link_title
689	link_title
683T	bracket
609	link_title
56魂不能亡	link_title
56變中肯了	bracket
56家族（56不能亡、5566得第一）	title
56家族	bold
56不能亡	bracket
56	link_title
5566版	link_title
5566板	link_title
5566得第一	bracket
5566	link_title
50之亂	link_title
500	link_title
50	link_title
4ni	link_title
4X貓	link_title
4XGAY	bold
484	bold
45度角的天空	bracket
42689.2	link_title
426	link_title
41J是一個軟體	bracket
41J嚴選	bracket
41J出品	bracket
41J、記者正確	title
41J	bracket
416事件	link_title
4%白蠊教	bracket
4%崩潰	bracket
4%仔	title
4%	title
3F用的是我寫的程式	bracket
39鬼王	bold
360安全衛士	bold
35人	bold
3310	link_title
30cm	link_title
307是公車中的霸主	bracket
3048	bold
2沒壞	bracket
2壞了	bracket
2q	bracket
286	bold
26用語	bracket
26、426	bold
26	link_title
259的選擇	bracket
250	link_title
24祖	bold
24個吉哥	bracket
228牽手吃香蕉 322補刀救台灣	bracket
2019年流行用語	title
2019年PTT最新訊息	link_title
2019年PTT事件	title
2019年PTT	link_title
2019nCoV板	link_title
2018年流行用語	title
2018年PTT最新訊息	link_title
2018年PTT事件	link_title
2018年PTT	link_title
2017年關鍵字之亂	link_title
2017年流行用語	title
2017年PTT最新訊息	link_title
2017年PTT事件	link_title
2017年PTT	link_title
2017年5月八卦板主補選	link_title
2017年10月八卦板板主選舉	link_title
2017年10月八卦板主選舉	link_title
2017年10月30日之ptt硬碟壞軌大斷線	link_title
2016年關鍵字之亂	link_title
2016年流行用語	title
2016年事件人物	link_title
2016年PTT最新訊息	link_title
2016年PTT事件	link_title
2016年PTT	link_title
2016 MAMA	bracket
2015年關鍵字之亂	link_title
2015年流行用語	title
2015年愚人節	link_title
2015年事件人物	link_title
2015年PTT事件	link_title
2015年PTT	link_title
2014年關鍵字之亂	link_title
2014年西斯雞排宴（西斯感謝祭）	link_title
2014年流行用語	title
2014年八卦板聚	link_title
2014年PTT事件	link_title
2014年PTT	link_title
2014年2月第4屆八卦板板主選舉	link_title
2013批踢踢冬季站服	link_title
2013年關鍵字之亂	link_title
2013年流行用語	title
2013年底西斯板請吃雞排事件	link_title
2013年代表「成語」與2014年代表「字」票選	link_title
2013年PTT事件	link_title
2013年PTT	link_title
2012年關鍵字之亂	link_title
2012年流行用語	title
2012年PTT事件	link_title
2012年PTT	link_title
2012年9月八卦板選舉	link_title
2012年9月八卦板主選舉	link_title
2011年流行用語	title
2011年PTT事件	link_title
2011年PTT	link_title
2010年流行用語	title
2010年PTT事件	link_title
2010年PTT	link_title
2009年關鍵字之亂	link_title
2009年流行用語	title
2009年PTT事件	link_title
2009年PTT	link_title
2008年流行用語	title
2008年PTT	link_title
2007年流行用語	title
2007年ptt系統權限異常事件	link_title
2007年PTT事件	link_title
2007年PTT	link_title
2006年事件	link_title
2006年PTT事件	link_title
2006年PTT	link_title
2005年PTT事件	link_title
2004年PTT事件	link_title
2004年PTT	link_title
20	link_title
1壞了	link_title
1989一念間	link_title
1985行動聯盟	bracket
1954	bold
1883氏	bracket
17歲發明小型的反應爐，3年內量產上市?	bracket
1450	link_title
133	bold
13212點	bold
132	bold
130	bold
12樓	bracket
127	bold
126	bold
12	title
118	link_title
11/20 自動販賣機爆走	bracket
100	link_title
1/60	link_title
1/1	link_title
036	link_title
.jpg	link_title
.__.\~/	bracket
...從智力方面評價，它們都沒有什麼價值，根本不是『科學』，更不是『智慧』。但再說一遍，而且要再說三遍，它們是權宜之計，權宜之計，權宜之計，摻雜著愚蠢、愚蠢、愚蠢...	bracket
.....	bracket
... = = 打錯字啦 魯蛇 魯蛇 魯蛇	bracket
+<><	bracket
+1	bracket
(筆記ing）	bold
(筆記)、(筆記ing）	title
(筆記)	bold
(母豬教)	link_title
(拔草)測風向	link_title
(づ′・ω・）づ	bold
(σ′▽‵)′▽‵)σ 哈哈哈哈～你看看你	bold
%%%	link_title
$$$$$$$$$$$$	bracket
#越想越不對勁	bracket
"馬黑派"	bold
"馬刺看人生，很多事情都值得細細品味和分享。這裡主要提供想法和討論，關於馬刺的即時訊息，請前往最優質的中文平台「禁區模範生」粉絲頁。"	bold
"都寫簡體字了 當然是指100人民幣啦XD"，"全世界最有錢政黨說沒錢"	bold
"趴一球"	bold
"超後悔投給柯P的"，"一切都是台北市長柯文哲的錯"	bold
"打得好就誇、打得不好就罵，有何不可？"、"思想檢查"、"一言堂"、"反智"、"斑馬迷"、"請討論籃球，不用討論口氣態度"	bold
"愛將籃球"	bold
"心機和體積一樣龐大"	bold
"外來種滾"	bold
"外來使用者決定八卦板主"	bold
"一言堂"、"思想檢查"、"反智"行為	bold
